####00101imagsviejas01.txt  ####Psicología T-Z:
- Tuberculosis: egoísmo que carcome. Pensamientos crueles. Posesividad. Deseo de venganza.
- Úlceras: miedo, creer (estar convencido) que no se vale lo suficiente.
- Urticaria: pequeños temores ocultos. Hacer una montaña de un grano de arena.
- Útero: creatividad.
- Varicela: se piensa en el siguiente problema o disgusto (hay que volver al presente tras planificar). Temor y tensión. Sensibilidad exagerada.
- Verrugas: manifestaciones de odio pequeñas. Creencia en la fealdad, ¿externa?
- Vértigo: fuga y dispersión de pensamiento. Negativa a mirar.
- Vitiligo: sensación de estar fuera de sitio, de no pertenecer al grupo.
- Vómitos: violento rechazo de ideas. Temor a lo nuevo.
- Zumbidos: negativa a escuchar. Tozudez. No oír la voz interior.
####Si usted me quiere en su vida, usted me pondrá en ella. Yo NO debería estar peleando por un puesto. Competir es antinatural en los humanos civilizados.
####Psicopatía (pómulos...):
- Su falta de remordimientos radica en la cosificación (atribuir cualidades de objeto a un ser vivo).
- Suele ser hermano mayor. Debido a celos y faltas emocionales, en el primogénito se va desarrollando una carencia relacional y afectiva, plasmándose en la falta de desarrollo de anchura, a nivel de pómulos (psicópata primario). ¿NO es siempre así NO? ¿Los de pómulos anchos imponen su voluntad de forma agresiva (esto es también malo)? Los narcisistas son estrategas / falsos (aunque de muy pequeños fueran agresivos).
- Separan perfectamente sentimientos de objetivos (sean buenos o malos), por lo que pueden ser jefes de banco... ¿Su autoconfianza (aunque realmente NO se quieran), falta de escrúpulos y mentir perfecto les permite conseguir lo que quieren? NO son realmente ni felices ni inteligentes (una persona inteligente NO se pierde ciertos útiles y dolorosos sentimientos, porque es fuerte; son débiles mentales). Se pueden emocionar hasta el llanto, pero a los 5 minutos vuelven a sonreír.
- Más sobre la cara. ¿Frente NO diferenciada (las diferenciadas tendrán bandas digo yo) muchas veces? ¿Nariz átona muchas veces (si es corta y pequeña, tendrán problemas de paciencia con los demás)?
####disfrutar la soledad es un superplus de inteligencia. Aquel que disfruta su soledad, escoge mejor las compañías, quien NO puede estar solo, escoge cualquier cosa, por desesperación. ¡Menudos cretinos!
####Cuando creas que las cosas empiezan a ir bien, probablemente irán mejor. Nada tiene más inercia que las buenas noticias (Rafael Vidac).
####Derechos fundamentales del niño (si reprime estas necesidades, de adulto...):
- Estar en brazos continuamente, teta... O acumulará cosas para llenar vacío.
- Que lo dejen experimentar, llevar cosas a la boca... o se sentirá reprimido sexualmente.
- Ayudar, hacer... confiando en él... o habrá miedo y límites a la hora de hacer (y no sabrá qué le gusta).
- Expresarse sin rechazos... o le costará transmitir sus ideas.
- NO ser mentido / protegido de la verdad... o al salir de su burbuja será un shock.
- Explorar su curiosidad, para contactar con su don... o será inconsciente.
####Zodiaco, complejos (y algo más):
- Aries: se consideran atractivos (ellos no necesitan adornos je je), pero al estar junto a alguien inteligente que NO los toma en cuenta, pueden sentirse disminuidos.
- Tauro: cuando comen mucho se odian y odian su entorno. NO ser económicamente solventes los hace sentirse inferiores.
- Géminis: se sienten mal si les acusan de hablar mucho y no cumplir promesas. Si no terminaron sus estudios, pueden aparentar (por complejo).
- Cancer: se avergüenzan si les dicen que no han superado el vínculo con la madre (querrán mostrarse independientes).
- Leo: inferioridad por padres inseguros, inestables, separados...
- Virgo: intentarán especializarse en algo / encajar en lo que sea (lo veo poco elevado) para camuflar sus complejos.
- Libra: el ridículo (no suelen mostrar sus debilidades) podría evitar su vida social (ser hermitaños).
- Escorpio: desarrollan muchas inseguridades, llenándolos de angustias y frustración. Por eso desarrollan complejos que los llenan de grandes temores, y que no quieren exponer (o ser rechazados por ellos).
- Sagi: los avergüenza que los vean caer. La soberbia podría hacerlos tomar caminos equivocados.
- Capri: sus inseguridades (muchas desde niños) los hacen necesitar verse a sí mismos y ante los demás como capaces y con carácter (física y profesionalemnmte perfectos). Sufren de complejos temores, miedo al abandono, baja autoestima...
- Acuario: pueden sentirse avergonzados por no saber algo (pero esto dura poco).
- Piscis: fuertes complejos de baja autoestima, ¿por sentir el abandono de sus padres? Se avergüenzan de sí mismos por ello, y buscarán con mucha intensidad ser amados.
####¡Todos los no inconscientes, al psicólogo por así decirlo! LOS CONSCIENTES VAN MÁS VECES AL PSICÓLOGO. LOS INCONSCIENTES NO DAN MUCHA IMPORTANCIA A SU LIMPIEZA DE PSIQUE. SE CREEN MÁS O MENOS COMPLETOS, ¡PERO QUÉ "SOBERBIA"! ¿Y LOS QUE CONOCEN EL MEDIO Y SUS MANIPULACIONES PERO NO SU INTERIOR?
####Condición necesaria amar a otros (Thayah Elim): amo tu sombra y tu parte luminosa porque he aprendido a amarlas en mí misma antes.
####Cuando perdonas a quien te látimo, le quitas poder sobre ti.
####Un trajeao (ni siquiera es un técnico, y menos, un espiritual) pregunta a un sabio el secreto de la felicidad eterna. El sabio le dice que está en NO discutir con ignorantes. El trajeao dice "no estoy de acuerdo". El sabio dice "tienes razón".
####Los amigos como los libros: ten sólo los mejores.
####Por qué tienes miedo a envejecer: reconoces que no vives la vida que quieres (es como usar mal el presente; hoy haces cosas importantes si has mirao bien en tu alma; mañana, ya se verá).
####Qué es sentir vegüenza: aparentar algo que no eres, no usar siempre la misma ropa modesta.
####Quienes no tienen remedio no me preocupan mucho. Estoy para despertar leones, NO ovejas crédulas y obedientes.
####Y aprendí a desaparecer de donde NO era bien recibido. NO era un simple truco de magia, sólo un ejercicio de dignidad.
####Si te sientes muy perdido la vida te facilita encuentros.
####Ve despacio: donde tienes que llegar... es a ti mismo.
####Si usted me conoce basado en lo que yo era un año atrás, usted ya no me conoce. Permítame presentarme de nuevo.
####00201imagsviejas02.txt  ####renacer las ciencias naturales tras profundizar mucho. EL PRIMER TRAGO DE LA COPA DE LAS CIENCIAS NATURALES TE VOLVERÁ ATEO; PERO EN EL FONDO DE ESA COPA TE ESPERA DIOS. ¿CITA DE HEISENBERG? EL BUEN CIENTÍFICO ES ESPIRITUAL (LA VIDA EN LA TIERRA ES UN AUTÉNTICO MILAGRO, PARECE "DISE‘ADA", AL MENOS, LOS PARÁMETROS FÍSICOS SON "UN DISE‘O").
####amenaza la gente cree que piensa (si los haces creer que piensan, te adorarán; quien busca que lo adoren, hablará bien de la gente. Quien realmente haga pensar a la gente con la verdad, será detestado por muchos).
####salud poner las manos sobre el corazón armoniza (¿la derecha, antes?).
####amenaza menos ganaderos y carne causa. JOSÉ MANUEL SOTO (NOP TAN MALO COMO SE CREE): SEQUÍAS HA HABIDO SIEMPR. Y EL MONTE ARDE PORQUE ESTÁ SUCIO DEBIDO AL ABANDONO, Y A LA ABSURDA PERSECUCIÓN A LA QUE SE HA SOMETIDO A GANADEROS, LE‘ADORES, APICULTORES Y TODO AQUEL QUE TIENE (O TENÍA) EN ÉL SU FORMA DE VIDA.
####amenaza NEFERmERAs usadas de agentes paios satánicos. LOS PAIOS LORITOS (ESBIRROS DE LAS ÉLITES, A VECES CON PICO DE METAL O SIMILAR) ENVENENABAN, QUEMABAN TIERRAS... ECHANDO AL CULPA A LOS BERE... A LO QUE FUESE (ME SUENA A LOS FALSOS ECOLOGISTAS Y EL TELEDIARIO, QUE ECHAN LA CULPA AL CAMBIO CLIMÁTICO, A LA GENTE... LAS ÉLITES MANEJAN AHORA LOS MEDIOS DE COMUNICACIÓN, 2.023). A LAS ENFERMERAS LES TOCÓ CUMPLIR SU PAPEL CON LA VENENOSA VACUNA DEL COVID (SÍ, UNA POR LO MENOS, ES VENENOSA). ¿Y CUANDO LA GRIPE ESPA‘OLA?
####amenaza terrorismo sentido común. CUANDO VEA A TERRORISTAS ATENTAR CONTRA INSTITUCIONES ESTATALES Y O CONTRA GENTE DE LA CALLE, PENSARÉ QUE LAS ÉLITES NO ESTÁN DETRÁS.
####sociología deja de identificarte con sentimientos que te alejan de la misión:
- TIENES QUE ESTAR CONSTANTEMENTE EN GUARDIA Y SER DESPIADADO CONTIGO MISMO. O TE ENCARI‘ES CON TU FORMA DE SER, PORQUE PUEDE ESCONDER MUCHOS PROBLEMAS PSICOLÓGICOS (LA PERSONALIDAD ES UNA MÁSCARA, SE PUEDE DECIR).
* CUANTO MÁS TE OBSERVES NEGATIVAMENTE (PERO COMPRENDIÉNTOTE, Y A LA VEZ, QUERIENDO CAMBIAR), MÁS CERCA ESTARÁ DE TU YO AUTÉNTICO, DEL ALMA Y SUS DESEOS / MISIONES.
- MUCHAS VECES, SE CONSIDERA LO MALO COMO UNA CUALIDAD, Y SE LE CONCEDEN NOMBRES COMO PASIÓN, CARÁCTER...
####Psicología H-I (ten en cuenta que hay más causas psicológicas, y que lo oficial y además bueno, aquí van los 2 unidos... es la NMGHamer):
- Hígado: hábito de quejarse. Justificación de las críticas para autoengañarse.
- Hiperactividad: temor. Sensación de estar presionado y frenético.
- Hipermetropía: temor al presente.
- Hipertiroidismo: rabia por haber sido dejado de lado.
- Hombros: con nuestra actitud NO positiva ante lo que nos sucede (puedes aprender...), hacemos de la vida una carga.
- Infecciones de hongos (el patógeno crece en "un mal terreno", NO soy de los que piensan que va por el aire): creencias estancadas (te aferras al pasado). Negación de las propias necesidades (no te autoapoyas).
* Infección (general): ciertas dudas, ¡las decisiones liberan! El parásito depende del "tipo de duda".
- Huesos / fracturas: rebelión contra la autoridad... NO hemos venido a hacer eso, sino a autocriticarnos con cariño (tras un poco de angustia).
- Incontinencia: exceso emocional que rebosa. Años de represión de las emociones.
- Indigestión: miedo visceral, terror, quejas, gruñidos...
####Psicología I-M (recuerda que muchas enfermedades pueden darse en fase de curación, invalidando estas causas):
- Insomnio: miedo a soltar el control consciente.
- Intestinos: terror de liberar lo ya NO necesario.
- Juanete: falta de alegría ante las experiencias de la vida. ¿Incluye las pruebas?
- Laringitis: furia que impide hablar. Miedo de hacerse valer. Resentimiento contra la autoridad.
- Lengua: enfado con uno mismo, culpabilidad.
- Retención de líquido: miedo a perderse algo.
- Llagas, irritaciones: rabia sin expresar.
- Malaria: ¿desequilibrio con la naturaleza y la vida?
- Mamas: negativa a cuidar de sí misma (en favor de los demás).
####Psicología M:
- Quistes, bultos, mastitis...: cuidados maternales exagerados, sobreproteger, actitud autoritaria.
- Mareo en barcos: miedo a la muerte, ¿ganas de tenerlo todo controlado?
- Mareo en coche: miedo. Sensación de estar cautivo.
- Mareo al moverse: miedo. Temor de NO estar al mando.
- Matriz: ¿que NO te entregas al xx%?
- Meningitis: rabia contra la vida.
- Menopausia: miedo a dejar de ser deseable o envejecer, autorechazo o sensación de valer poco.
- Migraña: aversión a ser manejado, resistencia al fluir de la sabia vida (da lecciones si sabes verlas; a veces, simplemente pagas karma o la vida te mete por ciertos caminos para hacer tiempo o que no vayas por otros), temores sexuales (prueba a masturbarte entonces, ¿sin necesidad de eyacular NO?).
- Miopía: miedo al futuro, desconfianza en el porvenir.
- Mordeduras: cólera o, ¿necesidad de castigo por creer en él?
####Psicología M-O:
- Nalgas flácidas: pérdida de poder.
- Nariz: goteo continuo (necesidad de ayuda, "llanto"), hemorragia (necesidad de reconocimiento, sensación de NO ser valorado, ansia de amor), moqueo hacia dentro ("llanto", puerilidad, victimismo), cargada (autodesvalorización).
- Náuseas: rechazo de una idea o una experiencia.
- Nerviosismo: desconfianza del proceso de la vida (NO es igual que la resistencia a lo que te pasa digo yo). Miedo, angustia, esfuerzo, precipitación. ¿Mucho esfuerzo es antiético? ¿Y si tu vida es de pagar karma?
- Neuralgia: castigo por una culpa. Angustia por razones de comunicación (¿con gargantas veloces o asperger?).
- Obesidad (sensibilidad exagerada, necesidad de protección, resistencia a perdonar):
* Brazos (rabia por falta / necesidad de amor).
* Caderas: terca cólera contra los padres.
* Muslos: cólera desde la infancia (contra el padre...).
* Vientre: rabia por falta de sustento (¿en un sentido amplio?).
####Psicología O-P:
- Oídos: obediencia (NO siempre es positiva).
- Ojos: capacidad de ver pasado, presente y futuro en su justa medida.
- Olor corporal: miedo (a la suegra je je). Disgusto consigo mismo. Despecho.
- Osteoporosis: sensación de No contar con apoyos.
- Pancreatitis: rechazo. Enfado y frustración porque la vida ya NO es dulce.
- Parálisis facial: control excesivo de la ira. Resistencia a expresar sentimientos.
- Parásitos: entrega del poder a otras personas.
- Parkinson: intenso deseo de controlarlo todo (por miedo).
- Pene: ¿energía?
- Picaduras: culpa por cosas pequeñas (lo simbólico produce lo material).
####00301imagsviejas03.txt  ####Psicología A:
- Aborto espontáneo: miedo al futuro...
- Accidentes: incapacidad de hacerse valer. Rebelión contra la autoridad.
- Achaques: ansia de amor, deseo de ser abrazado.
- Acné: no autoaceptarse / gustarse.
- Adicciones: enfado por tomr decisiones equivocadas. Alcoholismo: sensación de NO ser importante, culpa e incapacidad. Autorechazo.
- Aliento malo: rabia e ideas de venganza.
- Alzheimer: negarse a enfrentar la vida. Desamparo y desesperanza.
- Amigdalitis: miedo, emociones reprimidas. Creatividad aplastada.
- Amnesia: miedo. Huída de la vida, incapacidad de defenderse.
- Anemia: "sí, pero...". Falta de alegría. Miedo a la vida. Autodesvalorización.
####Psicología A-B:
- Ano: absceso (cólera realtiva a lo que NO se quiere soltar), dolor (culpa, deseo de castigo, NO valgo), Comezón (remordimiento, culpa por el pasado), fístula (aferrarse a las basuras del pasado).
- Anorexia: mucho miedo. Rechazo y odio hacia uno mismo. NO a la vida.
- Apatía: resistencia a sentir. Miedo.
- Apendicitis: miedo a la vida. Bloqueado "el flujo del bien".
- Sin apetito. Desconfianza de la vida. Exceso: necesidad de protección, juzgar las emociones.
- Arañazos: sentir que la vida estafa / desgarra.
- Arrugas: pensamientos depresivos...
- Arterias: relacionadas con el júbilo de la vida.
- Artritis reumatoidefuerte crítica a la autoridad, sensación de ser explotado. ¿Incluye resentimiento y NO ser amado (artritis normal)?
- Asfixia: temor, desconfianza en el proceso de la vida, estancado en la infancia.
- Asma (adultos): amor sofocado, incapacidad de respirar solo, "ahogo", llanto reprimido.
- Astigmatismo: temor a verse realmente.
- Cálculos biliares: amargura, pensamientos rígidos, juicios condenatorios, orgullo del malo.
- Bazo: obsesión, tendencia a abandonarse.
- Boca: apertura. Opiniones rígidas / cerradas. Llagas: tendencia a culpar y a retener palabras violentas.
####Psicología B-C:
- Bocio: odio por haber sido agraviado. Victimización. Frustración e insatisfacción.
- Brazos: abrazar las experiencias de la vida.
- Bronquitis: ambiente familiar conflictivo (peleas, gritos, mal silencio...).
- Bulimia: terror desesperado. ¿Odio a uno mismo?
- Cabello: libertad, poder. Calvicie: miedo y tensión. Intento de controlarlo todo. Desconfianza en el proceso de la vida.
* Canas: estrés. Presión machacante y esfuerzo excesivo.
- Dolor de cabeza: invalidación de uno mismo (mala autocrítica). Miedo.
- Calambres: tensión y miedo. Aferramiento.
- Callos: aferramiento terco al dolor del pasado.
* Callosidades: miedo. Ideas "endurecidas" (¿NO flexibles?).
- Cáncer: herida profunda. Rencor que se mantiene mucho tiempo. Secreto o aflicción profunda que carcome. Odios. Creer que todo es inútil.
- Cansancio, fatiga: resistencia, aburrimiento. Falta de amor por lo que se hace.
####Psicología C-D:
- Convulsiones: deso de huír de la familia, uno mismo o la vida.
- Corazón:
* Ataque: por ganar dinero o posición se ha arrancado la alegría del corazón.
* Problemas: entrega al esfuerzo y el estrés. Falta de alegría. Endurecimiento del corazón.
- Cuello: negativa a ver otros aspectos de un asunto (NO flexibilidad).
- Cuerpo. Derecho: donación, el padre. Izquierdo: recibir, comprender.
- Debilidad: cansancio mental.
- Dedos: pulgar (intelecto e inquietud), índice (miedo), medio (cólera y sexualidad), anular (uniones y aflicción), meñique (familia y falsedad). Artríticos: deseo de castigar. Acusar.
- Demencia: negativa a enfrentar el mundo tal como es (la gente normal en 2.023 es demente). Desesperanza y rabia.
####Psicología P-R:
- Piel: angustia, miedo. Antigua repugnancia encubierta. Sensación de amenaza.
- Piernas: miedo al futuro. Deseo de NO moverse.
- Pies: miedo al futuro y de NO avanzar en la vida.
- Próstata: ¿temores sobre la masculinidad?. Renuncia. Presión y culpa sexual. Creencia en el envejecimiento (¿curioso NO?).
- Pulmones: depresión. Aflicción. Sensación de NO ser digno de vivir plenamente.
- Quemaduras, rabia o furia ardientes.
- Rabia: fé en que la violencia es la respuesta.
- Raquitismo: falta de amor y seguridad.
- Cálculos renales: enfado / s NO resuelto / s.
- Resfriados, catarros: suceden demasiadas cosas a la vez. Confusión, desorden mental. Pequeños agravios. ¿Y ganas de que nos cuiden? Creencia en "los 3 resfriados cada Invierno" (creer es crear, y vibrar es atraer. Decir "contra el cáncer" es atraer el cáncer; el "medio" se queda con "cáncer", NO con "no" o "contra").
####Psicología R-S:
- Respiración: miedo o resistencia a aceptar al vida plenamente. Sensación de NO tener derecho a ocupar espacio o a existir.
- Reumatismo: sentirse víctima. Falta de amor. Amargura crónica. Resentimiento.
- Rigidez: pensamientos rígidos o cerrados.
- Riñones: decepción, fracaso, vergüenza, ser criticado. Reacciones pueriles.
- Rodillas: orgullo y obstinación. Incapacidad de inclinarse. Temor. Inflexibilidad. Terquedad.
- Ronquidos: terca negativa a abandonar viejas pautas mentales.
- Sangre: falta de alegría. Las ideas NO circulan.
- Sarna: pensamientos infectados. Permitir que otras personas nos acaparen el pensamiento.
- Sarpullido: irritación por los retrasos. Forma pueril de llamar la atención.
- Senilidad (regreso a la supuesta seguridad de la infancia): exigencia de cuidados y atención. Escapismo. Forma de controlar a quienes nos rodean.
####Psicología S-T:
- Síndrome premenstrual: confusión que domina. Entrega del poder a influencias externas. Rechazo de los procesos femeninos.
- Sinusitis: irritación contra persona muy cercana?
- Sobrepeso: miedo, necesidad de protección. Huida de los sentimientos. Inseguridad. Autorechazo. Búsqueda de satisfacción.
- Somnolencia: miedo a asumir las responsabilidades del día.
- Sordera: rechazo, terquedad, aislamiento ("no me molesten"...).
- Suicidio: negativa a ver otra salida.
- Suprarrenales: derrotismo, angustia. Renuncia a cuidar de uno mismo.
- Tétanos: necesidad de liberar sentimientos de cólera.
- Tics: miedo, sensación de ser observado por los demás.
- Tiroides: humillación. "¿Nunca puedo hacer lo que deseo?" Sí, no te victimices. "¿Cuando llegará mi turno"?
- Torceduras tobillos: ira y resistencia. NO querer avanzar en cierta dirección.
- Tos: deseo de decir al mundo: "escúchenme".
####00401imagsviejas04.txt  ####Psicología C (to desordenao, ¡pa que lo leas to je je!):
- Cataratas: incapacidad de mirar adelante con alegría.
- Celulitis: cólera acumulada y autocastigo.
- Cerebro: aquí hay como mínimo un tumor por enfermedad.
- Accidente cerebrovascular: rendición. Resistencia. Rechazo a la vida. "Antes morir que cambiar".
- Ciática: hipocresía. Temor por cuestión de dinero y al futuro.
- Joroba (cifosis): NO poder fluir con la vida (desconfiar...). Temor y aferrarse a ideas viejas. Falta de valentía en las convicciones o de integridad.
- Circulación: sentir o expresar emociones de forma negativa.
- Colesterol malo: miedo de aceptar la alegría.
- Cólicos: irritación emocional, impaciencia. Molestia por el entorno.
- Mucosidad en colon: revolcarse en el fango del pasado.
* Colon irritable: temor a relajarse, inseguridad.
- Columna: ¿falta de flexibilidad?
- Coma: miedo. Intento de escapar de alguien o algo.
- Conjuntivitis: enfado y frustración por lo que se ve en la vida.
####Psicología D-E:
- Depresión: enfado que NO se tiene derecho a sentir (tú lo crees).
- Desmayos: incapacidad de afrontar una situación.
- Hiperglucemia (diabetes): nostalgia de lo que pudo haber sido. Necesidad de controlar. Tristeza profunda. Falta de dulzura.
- Dientes: indecisión mantenida mucho tiempo. Incapacidad de analizar las ideas para decidir.
- Distrofia muscular: "NO vale la pena crecer".
- Dolor: culpa.
- Eccema: antagonismo intenso.
- Edema: despréndete de algo para sanar.
- Encías: falta de confianza, problemas para mantener decisiones, indiferencia ante la vida. Sangre = falta de alegría en las decisiones.
- Endometriosis: inseguridad, decepción y frustración. Sustitución del amor a uno mismo por azúcar. Tendencia a culpar.
####Psicología E:
- Enfermedad de transmisión sexual: culpa por la sexualidad. Idea de que los genitales son algo sucio. Maltrato a otra persona.
- Entumecimiento u hormigueo: represión en la manifestación de amor y consideración...
- Envejecimiento: vieja forma de pensar. Miedo a ser uno mismo. Rechazo del presente.
- Envenenamiento por alimento: permitir que otros asuman el control. Sentir indefensión.
- Epilepsia: sensación de ser perseguido, de pugna intensa. Rechazo de la vida. Violencia contra uno mismo.
- Equilibrio: pensamiendo disperso.
- Eructos: ¿quemar etapas demasiado rápido?
- Escalofríos: deseo de retirarse. "Déjenme en paz".
- Esclerodermia: autoprotección contra la vida. Desconfianza de la capacidad de autocuidarse.
- Esclerosis lateral amiotrópica: resistencia a aceptar al propia valía. Negación del éxito.
* E. múltiple: rigidez mental, dureza de corazón, miedo, ¿voluntad de hierro?
- Espalda (yo pensaba que la parte de arriba era la familia, y la de abajo la sexualidad):
* Parte superior: falta de apoyo emocional. Sensación de NO ser amado. Freno manifestando amor.
* Media: culpa. Atascamiento en el pasado. Sensación de carga.
* Inferior: miedo al dinero. Falta de apoyo económico.
* Inclinada: transporta las cargas de la vida. Desesperanza. Desamparo.
####Psicología E-G:
- Espasmos: tensión debida al miedo.
- Espinilla: ideales rotos.
- Esqueleto: ¿desvalorización? La estructura de la vida se desmorona.
- Esterilidad: miedo y resistencia al proceso de la vida. NO tener la necesidad de la experiencia de tener hijos.
- Estómago: temor a lo nuevo / incapacidad de asimilarlo.
- Estrabismo:
* Convergente: deseo de NO ver el exterior. Objetivos contradictorios.
* Divergente: temor a mirar el presente.
- Estreñimiento: negativa a abandonar viejas ideas. Mezquindad, tacañería. Estancamiento en el pasado.
- Fibromas y quistes: rencor contra novio / marido...
* Fibrosis quística: firme convicción de que la vida NO resultará bien. "Pobre de mí".
- Fiebre: ¿colera? Aparece mucho en fase de curación.
- Fístula: bloqueo intentando liberarte.
- Flebitis: rabia y frustración. Culpar a otros de la limitación y la falta de alegría.
- Frigidez: negación del placer. Creer que la sexualidad (el erotismo...) es mala (lo que es malo es mirarme con ojos libidinosos). Parejas sexuales insensibles. Temor al padre.
- Furúnculo: furia.
- Gangrena: pensamientos ponzoñosos que ahogan la alegría.
- Garganta (angustia?):
* Dolor, irritación: represión del enfado. Sentirse incapaz de expresarse.
* Nudo: miedo. Desconfianza del proceso de la vida.
* Problemas: incapacidad de hacerse valer (hacer que te respeten o tengan en consideración). Rabia reprimida y tragada. Creatividad sofocada, ¿por otro? Negativa a cambiar.
####Psicología G-H:
- Gastritis: incertidumbre prolongada. Fatalismo.
- Genitales: preocupación por NO sentirse valioso. NO es necesario sentirse valioso (hay tramos y tramos en la vida; y además, muchos tramos son de preparación).
- Glándulas: mala distribución de las ideas para organizarse y actuar. Autocontención.
- Glaucoma: necesidad de castigo por ser mala persona.
- Gota: necesidad de dominar. Impaciencia. Ira.
- Gripe: reacción ante creencias populares negativas. Miedo. Fé en las estadísticas (¿de gripe?).
- Hemorragias: se marcha la alegría. Fastidio.
- Hemorroides: miedo a los plazos establecidos. Rabia por el pasado. Temor a "aflojar". Sensación de carga.
- Hepatitis: resistencia al cambio. Miedo, ira, odio, indignación.
- Heridas: enfado con uno mismo y sentirse culpable.
- Hernia: relaciones rotas. tensiones, cargas. Expresión creativa incorrecta.
* Discal: sensación de NO recibir apoyos. Indecisión (hacer tests de misión espiritual: Nodo Norte, Tzolkin Maya, Diseño Humano...).
- Herpes genital: creencia popular en la culpa sexual y la necesidad de castigo (fé en un Dios que castiga...). Escarmiento público. Rechazo de lso genitales.
* Labial: enfado que carcome y temor de expresarlo.
####005notas01.txt  ####Los cuentos nos muestran ejemplos negativos de verdugos, salvadores y víctimas. Por ejemplo, Pulgarcito comenzó engañando a todo el mundo para sacar provecho.
####Algo de Cristian y Sofía. Percibimos como locos (porque lo estamos), porque percibimos sólo lo que nuestra relativamente débil mente puede "soportar" (lo que queremos, vamos); hay que pasar pruebas psicológicas para envejecer menos, no sólo está el taichí (y la buena comida, que si siempre comes bien, tu cuerpo no se fortalece).
- El punto de encaje / anclaje "filtra" la percepción, ¿también se llama así al conjunto de tus deficientes creencias actuales y similar?: donde alguien avanzado ve una inmoralidad, una persona normal puede reírse. Recibe información, y la transforma en una percepción.
* ¿Los obreros intelectuales no se cansan, porque son tan simples que no llegan a sintonizar "muchas cadenas"?
####MONSTRUOS (DE LA PSIQUE, Y EN EL INCONSCIENTE COLECTIVO):
##Empezamos con los monstruos bere (demonizados por los paios), que representan realmente a gente buena. Son la Grayas, Gerión... y yo diría que también Medusa, e incluso Cerbero, ¿y más? Probablemente:
- Las 3 viejas Grayas, femeninas (intuitivas más que de percepción 3D) y profundas, ¡son la demonización de las 3 Marías, las cosmonautas / xúrides bere!
* El 3 permite que un pensamiento se materialice, ¿a través de la emoción?
* Vivían en una oscura cueva, al Oeste (donde se pone el paio / satánico Sol).
* Vienen de un mundo con un tiempo más lento, ¿las prisas son masculinas?
- Medusa (una de las 3 Gorgonas):
* Atenea encontró a Medusa haciendo manitas, y la mandó a un lugar recóndito (porque era bere, y Atenea, un mito paio / paternalista, actual para aquel tiempo paio que sigue en el 2.023).
* Medusa refleja tu narcisismo, y al parecer, Perseo, poco tenía. Como sus enemigos no soportan la diferencia (tienen narcisismo), fueron vencidos (con la cabeza de Medusa).
- Gerión (3 torsos; los beres escandinavos trajeron el 3 a los paios españoles...), guardián de bueyes (y cada vez tenía más, gracias a que los pedía como peaje. ¡Los bueyes eran los que simpatizaban con la causa bere de acabar con lo paio / satánico, reconquistando el mundo para bien!). ¿Vivía en el Jardín de las Hespérides, un límite del mundo paio y bere? ¿Cerca del Atlas?:
* Euristeo le pide al paio HérCULes que robe esos bueyes, porque Euristeo no puede ni pedirlos ni comprarlos. Me suena a engañar a Alejandro Magno el reconquistador "venido del cielo". ¿Euristeo es el malvado Teo II, que engañó a Magno, quien fue asesinado? Hércules quiso aniquilar, nada de integrar. Era Paio, no bere.
* El buey es femenino (antipaio, antisolar). Representaba el mundo femenino anterior de los bere, el de hace más de 5.000 años. Gerión tiene la guadaña de Krono (anterior a Zeus). ¡Es de la época de los Titanes, que eran bere! ¡Los olímpicos no!
* El 3 es movimiento (hércules pone 3 semillitas y puede seguir).
- Cerbero guardián del inconsciente (vidas pasadas, deseos reales, represiones...). ¿Es el responsable de que reacciones mal por tus represiones? ¿Cuanto mayor el sistema de autoengaño / zona de represiones, más difícil conocerte no?
* Mito: Hércules le da comprensión (no se siente culpable accediendo a su psique, no dice "soy un monstruo represivo, simplemente soy represivo / malo, como todos"), y pasa al interior. Las creencias que no soportas (familiares...), pasan con mucha facilidad al inconsciente.
##Quimera (mezcla ridícula), barreras para el éxito:
* Estando cerca de Quimera, te metes en lo imaginario, y ya eres presa suya segura. UNA QUIMERA ES UNA AMENAZA IMAGINARIA QUE NOS AGITA INTERNAMENTE, Y QUE NO DEJA AVANZAR HACIA NUESTRO DESEO REAL / OBJETIVO INICIÁTICO. Terminas VICTIMIZÁNDOTE a veces (no puedo...). ¿Parte de la Quimera son las memorias ancestrales y las creencias negativas que te pasa tu familia (hacen más difícil el éxito material y social)?
* Hay que matar a Quimera de lejos, porque de cerca, estás perdido, comiéndote la cabeza, sin actuar.
* Los comienzos son difusos, los errores son inevitables hasta para "el mejor".
##Hidra de Lerna y el desánimo por autoconocerte en serio:
* Si le cortabas una cabeza, salían 2. Tenía una cabeza de oro, y si la cortas, la Hidra muere, ¿las otras estaban de despiste? TÚ MIRA QUÉ SITUACIONES SE REPITEN EN DIFERENTES ÁMBITOS DE TU VIDA: LA SOLUCIÓN ES EL COMÚN DENOMINADOR EMOCIONAL / PSÍQUICO. ¡Y ASÍ QUITAS UNA "REPRESIÓN" DE LA PSIQUE, NO REACCIONAS TAN MAL, ERES MEJOR PERSONA, TE AUTOENGA‘AS MENOS!
* Hércules ya estaba en el Inframundo antes de encontrársela, porque sabía que reaccionaba mal ante algo. Pero faltaba "ir al psicólogo".
##Esfinge griega. ¿Estás negando tu sombra / represiones / traumas? Se te puede aparecer. ¿Yo negaba incluso mis debilidades? ¿Hay que ser un macho je je, y si no, eres una mariposa? NO.
* ¿Aparece muchas veces en forma de estúpido MALOTE para que te importe menos lo que digan de ti?
* ¿Podía también ser una mujer que hacía una pregunta para casarse, y los que pretendían ser algo que no eran (machitos je je, que no aceptaban sus debilidades) morían?
* Cuando dices lo que te pasa y no imitas a los demás, la Esfinge pierde poder.
##León de Nemea (el león que se mea):
* ¿El León bueno, cómo es? Es el orgullo por haber mejorado profundamente (orgullo bueno).
* León malo: NO acorralable (su cueva tiene 2 salidas). NO puedes hablar con él, decirle la verdad, porque se ha vuelto loco, incoherente... con tanto reprimido. Si se la dices / entras en su cueva, sale por otro sitio con dolor por el choque de creencias (disonancia cognitiva), desechando la verdad externa (mecanismos de defensa para mentes débiles). Si algo te duele, mantén el dolor, tal vez lo externo sea la verdad. Quitar una creencia es un acto de valentía.
##Escila y Caribdis carácter femenino (¿representan "Coca o Pepsi, ¡nada, el tercer camino!"?):
* Estaban cerca una de otra, en un estrecho, y había que andar con pies de plomo. Representan el miedo del hombre a perder poder, en una sociedad paia patriarcal fundada tras la muerte del bere Alejandro Magno, hace unos 5.000 años. Son aspectos de "la madre terrible". Siempre hablando mal de las madrastras (que dan afecto a quien no parieron), lo femenino... ¡Hartos estamos! Charlie Sheen (2 Hombres y miedo) tenía miedo a las vaginas, y su personaje era horrible.
* ¿Platón nos invita sólo a ver la verdad material, lo externo, lo que menos cuenta de largo?
##Más (antes de los Titanes, que son bere):
- Quien va camino de ser buena gente, muere muchas veces, se transforma interiormente (desreprime), no exteriormente. La gente de bien ya no lleva máscaras / imagen.
- En las Hespérides estaba el árbol de la vida (hebreo):
* Los hebreos consiguieron el conocimiento bere; muchos, pa joder fuera de la tierra prometida, ¿son las 12 satánicas tribus viajeras? El 13 es el bere, el 12 es paio / solar. Veremos que una buena concepción de la Astrología es hebrea.
- Tifón el gigante (bere; los cíclopes son también enormes, pero tienen un sólo ojo y mucha destreza material y poca profundidad, así que son paios, que el uno es paio) es la destrucción, y Equidna (su contraparte sexual) es la madre terrible.
* Zeus no toca un pelo a Equidna y su prole. Van a ser necesarios para que los malditos Héroes paios luchen contra ellos y aprendan. Estos monstruos son de agua, emocionales, ¡tu sombra / represiones! Tu sombra espera a que la venzas CONSCIENTEMENTE, y que aprenda tu alma (tu alma es lo único que te llevas para las siguientes reencarnaciones).
####006notas02.txt  ####Titanes: eran bere, que eran enormes, comparados con los relativamente cabezudos paios. El pasado sigue en las celebraciones.####
####01, Océano miedo a lo desconocido. ¿Qué falsa creencia que me ata a mi zona de confort trata cada mito / titán (veremos cómo ellos representan la accion, y ellas la retraccion)?
- Representa la masa de agua infinita alrededor de lo conocido (zona de confort).
* Negativo: huir (la catatonia / enajenación también es huir, como desmayarse por miedo). O se combate de forma agresiva (¡esta música no es la de los setenta, lo que viví en mi infancia, mejor lo malo conocido!).
* Positivo: se acepta (vivir en una casa nueva, sea más o menos positiva que la anterior... ¿para aprender?). Incertidumbre: imagino lo que podría pasar, y a la vez no sé cómo prepararme para la situación, pero la acepto.
- Dar el paso hacia lo desconocido incluye responsabilizarte (y muchas veces, no elegir los otros caminos). Si no tienes ni idea de contabilidad, y tienes que decidir si coger un trabajo donde tienes que hacer algo de Contabilidad... eso es zona de inconfort.
* El miedo se pasa viviendo. ¿Planificando un poco, sin pasarse?
* Elegir a alguien para que te acompañe a atravesar lo desconocido, podría ser la primera responsabildiad.
####02, Tetis miedo a perder el confort (si voy por algo nuevo perderé algo viejo, y la vida podría ser peor). La niñera te protege... pero es la madre la que te invita a vivir experiencias (tocar una cafetera ardiendo...). ¡Criba / separa en montones de importancia cosas para autoconocerte!:
- Ejemplo. Llevas toda tu vida saliendo el fin de semana (discoteca), y no sabes cambiar eso.
* Sabes en qué fallas pero no bloqueas tu reacción al cambio.
- El miedo a morir está ligado a seguir al clan, sin diferencia positiva.
####03. Océano era como el miedo a perder opciones al elegir. Tetis era el miedo a perder lo conocido (incluye el "yo soy así"). Ceo es el miedo a ser rechazado. Con él te haces preguntas... y no avanzas. Cuando estás a punto de conseguir algo que no consiguío tu familia (una carrera universitaria que te importa mucho...), entras en crisis, y CEO va a aparecer. TIENES SENSACIÓN DE DEUDA (ARQUETIPO PATERNO).
- Mi familia está acostumbrada ya a mis rarezas (que son ser avanzado: no usar champú...).
- Cuanto más percibes (más avanzado), menos lanzado eres, eso sí.
####04 Febe dice: está bien que quieras salir de la zona de confort, pero no sabes. ¿Es una pitonisa, tiene que preverlo todo (me recuerda a mi ascendente Capricornio)? Déjalo pa mañana, ya has hecho bastante... Engaños. El Universo se cansa de que no pongas el cuerpo para acostumbrarte, y te manda tempestades.
- Digamos que si algo te da miedo, pero también sientes un cosquilleo / calorcillo pseudoagradable (¿en el estómago?)... es que el alma quiere ir allí, ¿aunque sea para aprender algo que ya no se usará en breve?
####05, Hiperión miedo a ver las cosas como realmente son (no "te subes a un árbol" para tener otra perspectiva). No quiero ver que en mi trabajo no soy feliz, que he gastao años pa na... Así, no se pueden tomar decisiones acertadas.
- "Ya pasará", piensas, "volveremos a la vida de antes". Cierras los ojos, aunque quieras entender lo que pasa (es una contradicción), eres irracional en el mal sentido.
####06, Tea te dice: no necesitas ir afuera, dentro se está muy bien, con tu colección de cuadros, videojuegos... Miedo al ridículo. ¿Por qué tanto miedo a la risa / burla del otro? Hay que comprender y perdonar al que se ríe (es titere de su zona de represiones, critica lo que no entiende...).
* Ley de TEA: tú eres lo que el otro ve / opina. Terminas desvalorizándote, y con complejo de superioridad a veces ("yo soy una buena vecina, y tú un mierda"; María Oliva).
####07, Jápeto "eres útil mientras hagas" (no valora la ancianidad, la sabiduria... ¿La enfermiza especializacion sí no?). El miedo asociado a Jápeto es a cambiar la psique para hacer algo distinto (es bastante taurino), aunque en lo de ahora fracases.
- ¿Qué creencia nos ofrece Jápeto? NO hay tiempo para lo que realmente deseo. ¿Porque "hay que currar" je je?
* CONTRADICCIÓN: DIGO "CÓMO ME GUSTARÍA...", PERO EN REALIDAD, NO SE HACE NADA POR CONSEGUIR LO DESEADO. Hay cansancio, frustración que no sabes muy bien de dónde viene...
* ¿Qué hacer? Dejar de hacer y ponermos a planificar. ¿Y luego sí empiezas vienen las musas no?
- La Psique, no sólo determina lo material, sino que el estudio de tu propia psique, es tu misión de vida.
####08, Temis miedo a mostrarte débil. Temis se ocupa de "hacer" las leyes naturales. ¿Quién castiga? Nemesis. Temis es "la temida", no Nemesis (lo importante y DIFÍCIL es saber la causa de por la que "Némesis te castigó").
- Mucha gente ve el tener miedo como signo de debilidad. En realidad, tienen miedo a mostrarse débiles. ¿Prefieren pegar antes de que les den? No se soporta la debilidad en otros, por un fallo interno.
- Cuando un adolescente actúa de forma violenta, probablemente tenga mucho miedo (quizás sus padres no le permitían expresarse, o no le daban afecto).
####09, Crío MIEDO A NO PERTENECER A UN CLAN (¿ser de un cantante, por ejemplo? Luego ves que el interior de ese cantante puede mejorar mucho). Mito: La orda (manada, indiferenciación) primitiva. Grupo (ovejas) reniega de quien da las órdenes, y lo matan, y entran en caos. ¿Pero el caos está bien para que todo funcione no? Caos = no estandarización, no límites en tu conocimiento benevolente.
- FALSA CREENCIA: no puedes solo (si fueses superparalítico, sería verdad). Acabas casi en cualquier clan.
####10, Nemosine miedo a ser olvidao.
- Mito: Eco se enamora de Narciso, y éste se ríe de ella, y ella se recluye en una cueva. Un pastor, enamorao de Eco, suplicó / lloró por la situación, y Némesis le oyó y castigó a Narciso por su desprecio, haciendo que se enamore de sí mismo, sin comer... Eco fijó expectativas, y cuando Narciso respondió de otra forma, Eco no pudo procesarlo / aceptarlo, y el dolor se apoderó de ella.
* O eres independiente emocionalmente, o no dejes que te mimen mucho, porque ahí está el enamoramiento (el otro te lleva inconscientemente a tu etapa infantil) con dependencia emocional y expectativas.
- Falsa creencia: no dejas huella histórica si no es a través del recuerdo del otro.
####11, Crono "me lo he ganao y no lo suelto":
- Chronos (la ch se lee como j; Jronos) es el Dios del tiempo, ¡PERO NO ES CRONO! CRONO ES SATURNO y lleva guadaña (agricultura).
* Alguien le dice a Crono que un hijo le iba a matar. Y cada vez que Rea paría, Crono se ponía la servilletita je je (un festín). El miedo es a ser desplazados ("yo soy el que cocina aquí", ¿y si tu trabajo "del alma" es otro?), a que alguien nos robe lo que creemos que es nuestro. Cuando asciendes fácilmente (zalamería...), te puedes volver paranoico.
- Creencia: lo nuevo es mejor que yo (la nueva pareja de tu expareja) y soy imprescindible.
####12 REA, Cibeles, miedo a perder el amor de los hijos. Creencia: una madre no puede ser una esposa, y viceversa.
####007notas03.txt  ####Para tu misión de vida no complazcas. Recuerda que si sigues tu misión de verdad (Tzolkin Maya, Nodo Norte, Diseño Humano...), serás feliz, y harás algo que se te dé bien, y serás mucho más útil. Termina estas frases. Te llevarán a un lugar olvidado de tu memoria infantil:
1. De niño yo quería un
2. De niño soñaba con ser (director de orquesta)
3. Cuando era pequeño mi escondite favorito era (los sótanos laberínticos)
4. Mi juguete favorito era (el Lego de ladrillos)
5. Mi mejor amigo se llamaba
6. Ahora mismo admiro a (muchos esotéricos / psicólogos)
7. Si pudiera volver atrás ahora mi profesión sería (hacedor de zuecos)
8. Mis hobbies son (La música de los 80, mirar las nubes, dirigir a la sociedad a un viaje interior)
9. De niño mis padres pensaban que era (inteligente, por sacar buenas notas)
10. En mi casa soñar despierto se consideraba (impensable)
11. Para mis padres los artistas eran
12. Para mis padres los hippies, punks, heavies... eran (unos descarados)
13. Las personas que se metían conmigo de pequeño ahora son/están (viviendo vidas normaluchas)
14. Busca tres personajes famosos que admires cuyas infancias fueron difíciles emocional o económicamente.
15. Busca tres personajes famosos que alcanzaron sus sueños a una edad muy avanzada.
####Los Eneatipos (Gurdjieff):
##Triada del Instinto (8, 9 y 1), viscerales:
- Quieren influir en el mundo. Temen ser dominados o explotados. Se vuelcan en la acción y se orientan al presente.
- Ira: el 8 la expresa, el 9 la niega, pero la expresa evadiéndose, el 1 la reprime.
##Del Sentimiento (3, 4, 2):
- Buscan sentirse amados.
- El 3 busca valor interior mediante logros externos. El 4 reafirma su valía sintiéndose especial. El 2 busca el amor demandando atención. Autovalorarse así NO es quererse (cuidao en general con cómo te autovaloras).
##Del pensamiento (6, 7, 5):
- Miedo (de no contar con los recursos necesarios). 6, necesita pautas o normas a seguir. 7, en apariencia valientes y aventureros, temen a su vacío interior. 5, se retiran y aíslan del mundo.
####Gestología (Ramón Maristani...):
- Psicomorfología del rostro:
* Cuadrado (optimistas e impacientes). Trapezoidal (inteligentes y explosivos).
* Redondo (optimistas y vulnerables). Ovalado (idealistas y orgullosos).
* Triangular (adivinación y astucia). Rombo (emotivos).
* Mentón fino: bloquea la salida del individuo, ¡falsedad! Grande: te agota en nada.
- Cabeza:
* Evitar contacto visual directo: no sé si estoy o no de acuerdo, ¡dame tiempo!
* Mirar hacia abajo: no entiendes tal vez lo que se te dice.
* Jugar con el pelo: falta de autoconfianza e incertidumbre.
* Jugar con la oreja: falta de atención o interés.
* Tirón a la oreja: inseguridad.
* Apretar nariz: evaluación negativa.
* Barbilla sobre puño: inseguridad.
- Extremidades:
* Delante del jefe, cruzar brazos o piernas: miedo a que él sepa lo que piensas.
* + sobre piernas. Unir tobillos: temor. Piernas estiradas y apoyadas sobre el escritorio: prepotencia e inseguridad. ¿A más abiertas en general, más agresividad? Sentados: paralelas y unidas, ordenado; cruzar por la rodilla torciendo, ansiedad, perfeccionismo e inseguridad; sobre una pierna (se esconde la otra), conformismo, dificultad para tomar decisiones.
* Cruzar dedos y manos: por delante, frustración o desengaño; por detrás, ira, temor, frustración...
- Nivel sexual. Cónyuges se tocan continuamente en público: inseguridad en una relación débil. Hombre se toca sus partes: a la hora de la verdad, es de los que escapan. Mujer pone objeto sobre los senos, ¿tiene un complejo de inferioridad por el tamaño de sus senos? ¿El objeto le da seguridad, la defiende de algo que da miedo, o de algo puramente psicológico?
- Más:
* Sentarse con manos agarrando cabeza por detrás: ínfulas de superioridad...
* Hacer preguntas necias para exhibir conocimientos: problemas con la autoridad.
* Ligera reverencia al estrechar la mano o despedirnos: consideración y cortesía.
####Grupos de trabajo. Pregunta por el objetivo "empresarial". Que los demás busquen la respuesta. Luego se resume en 2 frases (obvias o no) que consensúen más o menos.
- Con ignorantes: "sí, se puede probar"... Comprendo tu punto de vista, es interesante.
- Para gustar, ¡que te gusten otros! Mira sus facetas positivas.
####Memética (saber transmitir...):
* ¿Una frase se empieza relativamente rápido y se termina lento?
* Si los demás se hacen preguntas, es como si la idea hubiese salido de ellos.
* ¿Repetir algo a diario cala más hondo que la propagación exitosa y explosiva?
* Un nombre gana a un verbo: la satisfacción de...
* Hablar + rápido para los visuales (y con tono agudo).
* De vez en cuando alude al otro: "imagina que TUS pulmones...".
* No intentes caer bien (forzar risa) al que habla.
####16 personalidades (basadas en Jung; yo, INFJ, aunque a veces soy INTJ). La chispa surge con los complementarios, somos muy diferentes. Lo principal no es "estar colocao en un trabajo oficial", sino ser comprensivo:
- Características:
* Introversión (I) vs chupaenergías (E). Es importante que sean introspectivos (tanto I como E).
* Percepción sutil o 3D (baja). Intuición (N) vs sensación (S, 5 sentidos).
* Reflexión (T) vs emoción (F, más impulsivos). Los 2 me gustan.
* Juicio (J) vs percepción (P). Los "J" siguen con sus planes. Los 2 pueden ser útiles.
- INFJ1.5. La luz de la humanidad. Van por lo imposible. Diplomáticos y profundos.
- INFP4.4. Necesitan tener una cruzada o misión en la vida. Ven señales en todo. Imaginativos, solitarios. Les cuesta hablar de sí mismos con desconocidos.
- INTJ2.1. Líderes naturales. Confiados y originales pensadores. Mente maestra. Pueden estar solos. Trazan elaborados planes, y si fracasan... duele.
- INTP3.3. Intelectuales (el pensador). Nuevas teorías. Si les das salida para su inteligencia creativa...
- ISFJ13.8. Cálidos, generosos y muy formales. Servicial, el que nutre. Sacan lo mejor de quien les rodea.
- ISFP8.8. Piensan que conocer gente nueva enseña. Artistas, problemas de autoestima.
- ISTJ11.6. Reservado, muy responsable y formal. Inspector. ¿Intimidantes? Tranquilos y tradicionales por lo general.
- ISTP5.4. Artesano. Reservados (aunque a veces sorprende su espontaneidad).
- ENFJ2.5. Realizan sus sueños y los de los demás. Guiado por sentimientos. Éticos e idealistas. Confían bastante en su instinto e intuición.
- ENFP8.1. Encantadores, efervescentes y orientados a la gente. El campeón (ganador nato). Sociables. Se guían por sentimientos, pero son reflexivos y perspicaces.
- ENTJ1.8. Líderes naturales. Profundos. Equilibrio. Decisiones rápidas.
- ENTP3.2. Dinámicos. Si no triunfas a la primera, busca otra manera o "arrastra el error". El visionario. Odian las conversaciones banales. No rehuyen debates. ¿Vienen a revolucionar el mundo, con su comprensión más profunda / compleja?
- ESFJ12.3. Amistosos y cálidamente interesados en los otros. Proveedor. Centro de atención. Ayuda a débiles.
- ESFP8.5. Divertidos, aprovechan el momento. El actor (buenos captando nuestra atención). Preocupados por el bienestar ajeno.
- ESTJ8.7. Sencillos y directos. Supervisor / organizador. Orientación. Desafíos (les gustan).
- ESTP4.3. Aventureros. El hacedor (poca capacidad de abstracción). Aquí y ahora, y sus decisiones rápidas sin titubear pueden generar problemas.
####008notas04.txt  ####Astrología: la energía ambiental (para hacer introspección, ir por lo que quieres...), la marcan los planetas...:
- Signos:
* Yod (padre, voluntad, semilla, impulso fundamental): Aries (fuego), Cancer (agua), Libra (aire), Capricornio (tierra).
* He (madre, gestación): Leo, Escorpio, Acuario, Tauro. Época he: vivir desde las entrañas.
* Vav (hijo): Sagitario, Piscis, Géminis, Virgo. Época Vav: lógica y razón.
* El segundo He es el fruto que da el hijo, y que lleva las semillas de nuevas realizaciones. Época segundo he: se dispone de los medios materiales. ¡Y se vuelve al periodo yod!
* Ojo, que Aries es el primero (yod) de los yod. Doble yod. Con la misma lógica, Escorpio es el segundo de los he. Doble he. Géminis es súper Vav. Y los de Tierra (Capri, Tauro y Virgo), son de segundo he (disponen de los medios materiales).
- Más:
* Del amanecer al mediodía, Yod (Primavera, Luna Nueva). Del mediodía a la puesta de Sol, He (Verano, Creciente). De la puesta de Sol a medianoche, Vav (Otoño, Llena). De medianoche al amanecer, segundo He (Invierno, Menguante).
* Los bastos y los reyes son el Yod (relacionado con el fuego); las copas (agua) y las reinas, el He; las espadas y los caballos (aire = inteligencia estructuradora), el Vav; y los oros y las sotas, el segundo He (tierra).
* Antes los novios esperaban tres años para casarse (de Yod a Vav). Los aprendices esperaban tres años para ser oficiales (espero que haciendo y cobrando, modelo maestro / aprendiz), pero ahora todo se hace aceleradamente y todo se desploma con igual celeridad.
- Yo soy Escorpio con tendencia Piscis (el del medio), ascendente capri (la imagen, y lo que debo aprender a ser) y Luna en Leo (cómo siento...). Pero también tengo mucho Libra en la carta astral (acompañar a los demás, darles mensajes de ánimo...). Y alguien con conocimientos astrológicos me dijo que era "guerrero de Acuario" (mi Escorpio capta una inmoralidad, y mi Acuario, ¿se va a la guerra je je?).
####Signos:
- Aries sólo ambiciona la gloria de ser el primero, el héroe. Cuando "la empresa" se consolida, Aries comprenderá que aquello no es para él.
* Aries recibe información "divina" para actuar sin pensárselo mucho. La Providencia le saca de apuros.
* Las dos primeras horas de luz solar se encuentran bajo su dominio.
- Leo nos permite interiorizar las energías divinas (en Aries "rebotan"):
* Sabe confusamente que es preciso ser FIEL a un ideal superior y que la obediencia es una virtud fundamental. Será el guardián de la ley, de la moral, de las costumbres, de las tradiciones.
* Negativamente: es un actor que interpreta un papel previamente escrito, y si ese papel es el de "malo"... Un excesivo número de planetas en Leo dará lugar a un individuo atado a demasiadas fidelidades (se volverá contra él).
- Sagitario. Será portador de normas morales concretas, expresadas en ideas claras.
* Exceso planetas: creador de instituciones poco atendidas cada una de ellas.
- Cáncer. Ya se persigue un objetivo personal. Para su obra, se encierra en un recinto (hogar...) para mejor amar y adorar aquello que siente como suyo.
* Ya no oye voces, pero siente que algo inefable hay más allá y lo venera a través de la fé.
* Exceso planetas: tendencia al aislamiento y al cambio de residencia, exceso de emotividad, individualismo y egoísmo.
- Escorpio: fidelidad a un amor, a unos sentimientos. Volver al pasado será una constante tentación: anteriores vidas, la madre, la ciudad natal... Duele superarlo.
* Malos aspectos planetarios: deudas Kármicas ineludibles, asimilación de substancias sentimentales venenosas. Exceso planetas: naturaleza apasionada y actividad sexual multiplicada.
- Piscis, instituye (como Sagi). Pruebas y sacrificios (para renunciar a algunas ambiciones sentimentales). Comportamiento poco lógico (sentimental).
* Malos aspectos: exteriorizaciones difíciles (y de sentimientos que en realidad no tiene), precipitadas, fuera de lugar, y timideces e inhibiciones. Exceso planetas: mucha exteriorización; siempre estará enamorado de alguien, pero sin profundidad.
- Libra: compartir la obra anterior para adquirir magnitud y relevancia. ¿Busca complementario?
* Malos aspectos: dificultan la unión (matrimonial, integraciones en la sociedad...). Exceso de planetas: unirse a los demás con tantas ganas, que puede militar en un partido de derechas y de izquierdas al mismo tiempo.
- Acuario. Es el inventor, el que traduce una ley universal a un esquema particular.
* La mente justifica estados emocionales que debería haber educado (todavía hay emoción).
* Malos aspectos: no es tan de pensamiento, se cometen errores de interpretación (filosofía, palabras e ideas ajenas...). Exceso planetas: es como una máquina tecnocrática.
- Géminis (convencer).
* El elevado porta libertad, orden y trascendencia. Cuando habla o escribe, sana, NO abruma. El bajo dará a la sociedad razones "científicas" para equivocarse.
* Malos aspectos: falso testimonio de sí mismo. Exceso planetas: sentirá que en todo momento y en todo lugar debe poner la impronta de su pensamiento (y meterá la pata como "politólogo").
- Capri. Edificadores de casas, son también edificadores del templo del espíritu, si son lo suficientemente avanzados para ello.
* Malos aspectos: mala elección del material para la obra o el negocio. ¿Eligen a los cantantes? Exceso planetas: volcado a las realizaciones materiales.
- Tauro goza de lo construido en la etapa anterior. Todo le es dado con facilidad. Es el tesorero, el rentista, el opulento...
* Si está desarrollado espiritualmente, será el promotor del arte y la ciencia (la moral, no creo).
* Malos aspectos: mala asimilación del alimento, poco apetito, mala salud. Desgana de vivir. Incapacidad de apreciar la felicidad material, hacia los placeres... que puede ser origen de impotencia y frigidez. Exceso planetas: apegado a lo material. Goza, se divierte y no hace nada más.
- Virgo observa y analiza la materia. Si vive las cualidades del signo en toda su plenitud, acabará dando la espalda a la materia y descubriendo la espiritualidad:
* El Virgo bajo sentirá que su situación material es precaria, e intentará prevenir la catástrofe guardando y acaparando, ocultando sus bienes a los familiares, para que éstos no los derrochen.
* Debe seleccionar qué tiene que abandonar la sociedad, para ir a una socidad mejor.
* Malos aspectos: digestiones lentas, sensibilidad de aparato digestivo, úlceras. Intentará por todos los medios mantener unos privilegios que se irán derrumbando. Exceso planetas: tendencia exagerada al detalle ínfimo, a la observación de sus propios procesos vitales; y de ahí la manía de sentirse enfermo y adoptar medidas higiénicas exageradas.
* ¡Eh, fuera las divas exhibicionistas ya!
####009notas05.txt  ####LAS CASAS ASTRALES. ¿Qué significa Marte en Piscis en casa 10, que hay mucha energía (Marte) pa trabajos (10) pa los desfavorecidos (muy tratados por Piscis)? ¿Y casa 10 en Piscis, que tu trabajo se enfoca a los desfavorecidos, a lo creativo...?). La Casa I o Ascendente señalará el signo en el Este cuando nacimos (y depende del lugar de nacimiento). ¿Cada dos horas el Ascendente cambiará de signo? En España, si naciste más o menos a las 9:00, tu ascendente coincide con tu signo principal / solar. Vamos con las casas:
- Casa I, personalidad (máscara) y silueta física (mi ascendente es Capri).
* Malos aspectos: la sociedad, la familia, el cónyuge, el medio profesional... no serán los idóneos para la manifestación de su personalidad y deberá luchar, ¿toda su vida? contra esa adversidad. Exceso planetas: necesidad imperiosa de sobresalir, realizar hazañas, sean las que sean. Fácilmente manipulable. Egoísmo.
- Casa II. Tauro, recompensa y descanso. Indicará en qué hemos trabajado anteriormente y que ahora da frutos. Nos dirá de dónde sacará el individuo su sustento material: en signos de fuego, la Providencia proveerá; en signos de agua, los sentimientos serán el principal motor de los ingresos; en signos de aire, el provecho vendrá de trabajos intelectuales (yo la tengo en Acuario); en signos de tierra, el sustento provendrá de un trabajo material.
* Malos aspectos: los recursos le vendrán de manera forzada, dramática, y si esos malos aspectos son múltiples, pueden significar el impedimento total a la persona de alcanzar los medios que han de sostenerla. ¿Me corté en una vida anterior de la corriente del amor familiar, eros, comunitario, o coherente? Exceso planetas: los bienes materiales tendrán una prioridad absoluta.
- Casa III, Géminis (familia, vecinos...). Géminis recoge la información procedente del mundo material, ¿y va a Acuario y Libra? Un corto viaje bastará para descubrir lo semejante a él, si es que no lo descubrimos en la misma esquina de la calle en que vivimos. Regirá los intercambios escritos y hablados: es significativo que cuando Mercurio se encuentra en movimiento retrógrado, casi siempre hay huelga de Correos.
* Malos aspectos: hermanos dificultarán su acceso a la compañía de personas semejantes a él, y los medios de expresión a su alcance no serán los adecuados para manifestar su potencialidad intelectual. "No aprende" con las experiencias. El individuo no encuentra su puesto. Exceso planetas: hablará inconteniblemente de tonterías y escribirá aún más.
- Casa IV, Cáncer. Vida privada del individuo y posesiones materiales. Antepasados, infancia, barrio natal, los que viven en su hogar y su comportamiento en la casa y en la vida de familia. Todo lo relacionado con la madre.
* Malos aspectos: todo resultará precario, empezando por su propia madre, que carecerá o de medios o de inteligencia para orientar adecuadamente al individuo. Hogar inestable, dificultad para echar raíces, la vida a la intemperie, dificultades en la ciudad natal. Exceso planetas: hogar ambulante, emocionalidad profunda aunque no aparente. En casos extremos, herencia malsana, enfermedades hereditarias, enfermedades contraídas en el claustro materno.
- Casa V, Leo, premio al esfuerzo (por parte de "Dios"). Si la Casa "de Aries" está atrofiada, no cabe esperar prodigios en ésta. Se pueden recibir dones buenos o malos (azar) procedentes del pasado. Puedes encontrar tu alma gemela (si hubo suerte). Si no, la persona puede ganar a la lotería... Si se encuentra en fuego (hasta 21 años), el amor vendrá de la infancia y será debido a méritos anteriores. ¿También habla de nuestros hijos y su calidad? ¿Dice si vas a mostrar mucho a los demás? Habla de los hobbies (si son deportes, el azar puede darte plenitud física).
* Malos aspectos: malas recompensas, mala progenie, mal ejemplo dado por el individuo, mala utilización de la libertad y de los placeres que ofrece la vida, amores fatales y perturbatorios. Exceso planetas: demasiadas recompensas del pasado. Quizás pase toda su vida sin realizar el menor esfuerzo.
- Casa VI, Virgo. ¿Dice cómo pagamos las deudas del ciclo (con servicio se supone, y posiblemente humillante)? Al transitar el Sol por nuestra Casa VI todos deberíamos liquidar las deudas del año. ¿Habla de los que están a nuestro servicio, y que encontraremos en otra vida mandando sobre nosotros si no sabemos darles su merecido? ¿Y hay pequeñas enfermedades para evolucionar?
* Malos aspectos: salud precaria, subordinación a otras personas. Exceso planetas: saldar sus deudas a la fuerza (con poca libertad).
- Casa VII, Libra. Búsqueda del complemento. Los matrimonios concertados aportan estabilidad. Encontraremos información sobre el cónyuge, y la personalidad de los socios, aliados, y "enemigos" (nos dicen lo malo nuestro). Veremos la reacción de la sociedad ante nuestras iniciativas.
* Malos aspectos: cónyuge de mal carácter, malas cualidades o con problemas psicológicos, de salud, de dinero... Aliados problemáticos, y mala reacción social a nuestras iniciativas. Exceso planetas: literalmente aplastado por el otro. ¿Debe evitar la confrontación?
- Casa VIII, Escorpio. En Escorpio los sentimientos se concentran convirtiéndose en poderes interiores. Personalidad erótica. ¡La música es en parte erotismo "gritado" (new wave)! Dinero ganado sin esfuerzo (cónyuge...), herencias, donaciones, rentabilidad del capital... Muerte violenta o suave. Sensibilidad respecto al más allá, indicando posibilidades de progreso espiritual.
* Malos aspectos: el estado de fortuna de los aliados es precario, o será difícil que su dinero llegue hasta nosotros.
Exceso planetas: dependencia de la fortuna de los demás y estar atado a intereses...
- Casa IX, Sagi. Saber si la fuerza moral / conciencia del individuo es mucha o poca. Rige los viajes largos.
* Malos aspectos: puede ser un fanático religioso o un ateo y expresará una moral arbitraria y falsa. Viajes tempestuosos, arriesgados, difíciles y pobres en resultados: exilios, proscripciones, fugas... Exceso planetas: frecuentes cambios en la línea moral / religiones del individuo, se verá obligado a viajar constantemente.
- Casa X o Mediocielo, Capri. Profesión: fuego, valores Morales (sacerdocio, filosofía, política, enseñanza, conocimiento profundo de las cosas). Agua: alimentar los instintos, los deseos, los sueños de la humanidad. Aire: trabajador intelectual con ideas, o servir una idea, filosófica o no. Tierra: alterar la forma de objetos, de una manera u otra. El padre, la prohibicion a nosotros mismos. Si nos alejamos de nuestro alma (en 2.023, la sociedad es así), tendremos un padre violento, o huidizo, o borracho, o pobre en recursos...
* Malos aspectos: obstaculizarán la vida profesional, así como las relaciones con el padre. El trabajo carecerá de continuidad y no será el más apropiado a sus aptitudes. Exceso planetas: director general de algo (a veces casi sin esfuerzo). Persona extravertida, con intensa vida social de festejos, fiestas mundanas que le darán ocasión de relacionarse y obtener ventajosos puestos profesionales, pero se verá privado de toda intimidad y no podrá echar raíces en nada.
- Casa XI, Acuario. Apoyos, amigos, protectores (estos encuentran en nosotros la posibilidad de llevar a la madurez sus propios ideales).
* Malos aspectos: dificultarán las relaciones y pondrán obstáculos en la realización de los proyectos. Nos darán amigos con problemas (para ayudarlos, en vez de al revés). Exceso planetas: comprometido en demasiados proyectos. Sus amigos son muy dispares y todos lo lanzan a horizontes distintos, e invadirá dominios en los que no debería poner los pies.
####010notas06.txt  - Casa XII, Piscis. Viviremos "injusticias" (en parte por haber tenido deseos en Cancer gozados en Escorpio, que no tienen que ver con desreprimir y eso): enemigos, pruebas, restricciones... Lugar de purificación y puerta de acceso a los mundos superiores. Sentimientos exaltados y puros. En signos de fuego, será víctima de inmoralidades y él mismo expuesto a grandes tentaciones morales. Ejemplo: encarna en una familia de ladrones, que le inducirá al delito. Agua, pruebas de tipo sentimental: traiciones, infidelidades, amores rotos. Aire: el individuo se encontrará a merced de sus enemigos ideológicos, militando en grupos condenados a la oposición. Tierra: enfermedades, cárceles, pérdida de bienes materiales, accidentes...
* Exceso planetas: vida retirada, de sumisión al destino.
####LOS BELENETAS. ¿Neptuno y Plutón pertenecen a un sistema solar fronterizo, pero ejercen sobre nosotros una influencia creciente? Vulcano es el de Virgo (el de Tauro sería "Apolo"). Para descubrirlo, es preciso que exista en nuestro fuero interno actuando por algún tiempo...
- Los planetas son la expresión material de cada uno de los Séfiras que figuran en el árbol cabalístico.
* Saturno es el regente de Acuario y Capricornio. Júpiter rige Sagitario y Piscis. Marte rige Aries y Escorpio. Venus rige Libra y Tauro. Mercurio rige Géminis y Virgo. El Sol rige Leo. La Luna rige Cáncer. Pero Plutón rige Escorpio, Neptuno Pige Piscis, y Urano rige Acuario.
* ¿El hierro procede de las vibraciones de Marte y el estaño de las de Júpiter?
##Los belenetas:
- Urano. La radiación crística (viene de aquí) se manifiesta cuatro veces por año, y destruye el mal (lo que no vibra alto), restableciendo la salud en los organismos enfermos.
* Nos jode la vida, a fin de que podamos reconocer nuestra oscuridad y sintamos el afán de pureza y de luz. Pero también nos aporta la sabiduría divina en nuestras acciones humanas, para inventos...
* Malos aspectos: o bien ahogan su radiación de amor, con planetas reductores como Saturno o Mercurio, o aumentan su poder desintegrador (amplificadores como Júpiter, Venus, el Sol y Marte).
- Saturno es sacrificio (Binah sacrificó parte de su luz para cristalizar nuestro mundo).
* Saturno en Acuario: bueno para los inventores.
* Con los materiales de Capricornio, Saturno instituye nuestro destino (sin detalles). Tendrá en cuenta el karma a pagar, y las necesidades de nuestra evolución (limpieza de psique...). Será el que nos ponga los malotes, y de nosotros dependerá el que aprendamos de la situación, o NO (persiguiéndolos, pidiendo que se nos haga "justicia", con lo cual sólo conseguiremos prolongar la situación).
* Malos aspectos: marco de vida accidentado, difícil, peligroso. Si esos malos aspectos proceden del violento Marte, cuidado.
- Júpiter representará la aplicación de la ley de Saturno. Cuando "NO concuerdan", ¿veremos al individuo enfrentado con la autoridad o corrupto? Júpiter indicará aquello que el individuo poseerá en abundancia y señalará el dominio en el que ejercerá el poder.
* A través de Sagitario, es portador de fuerza moral, de generosidad, que pulveriza los rencores... En Piscis, Júpiter suaviza sentimientos, para que no se produzca mal karma.
* Malos aspectos: o bien reducirán los poderes, o harán que ese poder sea arrogante, con corrupción y excesos.
- Marte. Todo lo excesivo que el tolerante Júpiter ha edificado se verá demolido. El riguroso Marte nos indicará el cómo regenerar la naturaleza corrompida. Marte es el planeta del trabajo e indica las aptitudes del individuo para un trabajo determinado.
* En Aries, Marte proyecta su esencia zodiacal con fuerza a la cabeza del individuo. Con Escorpio, es el productor de todas las formas materiales que crea el hombre gracias a su trabajo. Si las pulsiones de nuestra voluntad van hacia la espiritualización, tendremos a nuestro servicio a los luciferianos que trabajan con Aries; si van para abajo, tendremos a los que operan con Escorpio. ¿Producir es negativo entonces je je?
* Malos aspectos: individuos impotentes (Escorpio), o locos (Aries). Si son de naturaleza amplificadora, podríamos tener a una persona obsesionada con el sexo o un "iluminado" extravagante. Resultarán perturbatorios para el trabajo (no participación o dedicación excesiva y violenta).
- En el Sol reside la experiencia de nuestro pasado ancestral (dones y talentos). Es quien recoge los impulsos planetarios y los ejecuta (para ello debe actuar con las relaciones planetarias?). Un trígono de Mercurio con Neptuno, que da una elevada inspiración, sólo tendrá efectos si el individuo posee ya un talento de escritor o de artista (dado por el Sol):
* ¿La negatividad no expresada del hombre está en su Luna, y la de la mujer, en su Sol? ¿Con Sol en Leo, el marido expresará el Sol de la mujer, y la mujer la Luna del marido? Para conocer auténticamente a una persona A, es preciso conocer a su cónyuge B, que expresará la parte NEGATIVA de A que no se ve y que el mismo A ignora. Si somos varones y nos vemos superiores, en otra vida volveremos a ser varón (esposa cada vez más salvaje, karma; el camino termina como mujer, con marido desarrollado, imposible de seguir).
- Venus. Nos indicará lo que al individuo le tocará reconstruir, embellecer, armonizar; y aquello que expresará con gracia, con arte; y aquello que lo hará sobresalir. Resolver crisis.
* Libra: armonizar. Tauro: gozo de la belleza y de la armonía y uso superficial: moda, perfume, decoración suntuosa. Venus confunde y envenena con superficialidad. Y los "venusianos" se creen elevados, y creen que tocaron techo.
* Malos aspectos: sed de lujo, armonía, placeres o coexistencia pacífica. De manera delicada y exquisita, acaba con lo elevado.
- Mercurio (intelectualidad) corrige a Venus. Posición fuerte de Mercurio: capacidad de análisis, crítica, síntesis y de discernir la verdad encerrada en cada cosa. El Mercurio común corresponde a Géminis (exteriorizar ideas), y el filosófico / alquímico a Virgo (lo femenino / interior).
* En Géminis: aporta discernimiento. Virgo: se conduce a la quintaesencia de las experiencias adquiridas en los cuatro ciclos elementales: fuego, agua, aire, tierra.
* Malos aspectos: el individuo no ve las oportunidades, porque la conexión entre la realidad material y la función inteligente está alterada. No acertarán a incorporar el concentrado de sus experiencias totales, lo cual conducirá a tropezar dos veces con la misma piedra.
- ¿La Luna es la responsable de las imágenes aparecidas en nuestro mundo interior (de vivencias...)? La calidad, depende de su posición.
* Malos aspectos: puede que un planeta determinado monopolice la producción de imágenes. Para una mujer, carácter difícil. Para un hombre, captación de una mujer difícil, y para ambos, madre conflictiva.
- ¿Neptuno (como planeta fronterizo de otro sistema) se parece a Urano (espiritualidad)?
* Malos aspectos: acentuarán su personalidad extraña: fantasioso, excéntrico.
- Plutón es hermano de Saturno. Saca al exterior lo que estaba profundamente enterrado, para mejorar.
* Los individuos son aún poco sensibles a las vibraciones de Plutón. Hace que estalle lo caduco y se regenere lo corrupto. Malos aspectos: auténticas cargas de dinamita.
####011notas07.txt  ####Existe la carta de Revolución Solar (que se empieza a activar unos 2 meses antes del cumpleaños). Puedes ser otros signos (misión y capacidades; yo, con mi cumple del 3 de Noviembre de 2.023, pasé a ser de misión Piscis, con capacidades Cancer; eso se acaba con el siguiente cumpleaños, claro).
- Y no te olvides de que el año 9 de cada ciclo de 9, es un año "Virgo" (seleccionar cosas pa tirar o dejar...).
####Misiones zodiacales (signo principal / solar):
- Aries habla de expansión, y de iniciar proyectos que luego abandona. Acción sin hacerse casi preguntas.
- Tauro empieza donde Aries lo dejó. No debe preguntar nada o cambiar de parecer o confiar a los demás su solitaria tarea. Cuidan.
- Géminis, curiosísimos. Llegan a saber la suciedad del sistema mejor de lo normal. Comunicación.
- Cancer enseña emociones, para que desarrollemos la plenitud interior (ser compasivo...). Don de la FAMILIA.
- Leo, mostrarás "el mundo". No es tu creación. Alegría trabajando. Honestidad.
- Virgo vigila y analiza, criticando con pureza de juicio (no he dicho sabiduría).
- Libra, despierta en el Hombre la conciencia hacia los demás. Don del afecto y de suavizar la discordia. Hacer conscientes a los demás signos de sus misiones, y sus relaciones con los otros signos.
- Escorpio: les dice a los demás que todo se hace con un propósito. Su tarea es conocer a los demás signos y sacar lo mejor que tienen para completar sus misiones, ¿sin decirles nada directamente? Verá tanto en las demás personas, que a veces se sentirá "rodeado de caimanes". Dada su dureza, les tocará ver cosas muy dolorosas.
- Sagitario, enseña al Hombre la Alegría (sin usar la risa como defensa) y el optimismo. Conocerás la inquietud de cada una de las muchas vidas que toques. Don de la ABUNDANCIA INFINITA, aportando luz en muchos lugares, ¡misionero!
- Capricornio, enseña al Hombre a trabajar (con descansitos, pero con constancia). Don de la responsabilidad. Ayudar a cargar con las tareas de los demás mientras aprenden a realizarlas.
- Acuario, el Conocimiento del Futuro para nuevas posibilidades. Don de la LIBERTAD.
- Piscis, absorberás penas; ampara, anima... Cuando trates de difundir las leyes naturales / universales / espirituales, el Hombre no te escuchará. Haz al otro confiar en sus capacidades para que lo intente de nuevo si falla en sus misiones.
####Misiones si tienes este ascendente:
- Aries. Aprender a actuar rápido y tomar decisiones bajo presión.
- Tauro: aprende que todo lleva su tiempo en la naturaleza. ¿Gozar produciendo y acumulando? ¿Vida en el campo?
- Géminis: aprender a relacionarse con hermanos o compañeros que no sean iguales. Debe conectar "sus 2 seres" para que haya "evolución".
- Cáncer: estará rodeado de gente que exprese calidez, y emocionalidad respecto al pasado. Si el signo principal es de aire, le costará entrar en su parte sensible, y podría vivir aventuras que sólo son para los de aire (significa presión, malestar...).
- Leo: se codearán con figuras de autoridad fuertes. Los imitará, pero tarde o temprano, su vacío afectivo le hará buscarse a sí mismo.
- Virgo: la vida plantea escenarios de gran potencialidad, dentro de contextos de pocas posibilidades (enfermedades, situación económica, penosidad en general...).
- Libra: de peque, aprende a apreciar la belleza y a desarrollar su potencial artístico. Tiene que aprender que relacionarse socialmente no es igual a depender emocionalmente.
- Escorpio: familiarizarse consigo mismo a través de personas / situaciones con su alta y conflictiva intensidad emocional. Está obligado a descubrirse a sí mismo y el lado oscuro de la naturaleza humana a una edad más temprana que el resto de la gente.
- Sagitario: viajar al extranjero o mucho. Conexión con Filosofías o religiones. Conexión con Maestro que imparte ideas profundas e invita a ver más allá (para dar luego sentido a vidas de otros).
- Capricornio: vivir experiencias severas, mientras asume enormes responsabilidades (¿obras largas, por ejemplo?) sin la posibilidad de apoyarse en otros. Aprender a postergar intereses inmediatos, y recompensas sólo al final.
- Acuario: muchos imprevistos: mala suerte, crisis inexplicables... Con el tiempo, se verán como oportunidades creativas y liberadoras. Muchas personas / situaciones que rompen las reglas y son originales (para aprender libertad y espontaneidad). Notables habilidades científicas o tecnológicas.
- Piscis: todo es confuso, como sólo entendible con una percepción "mágica". ¿Y qué hace mal Piscis (ascendente)? Desconfían de sus propias percepciones buscando racionalidad... Captan los efectos mágicos de la música, la creatividad artística...







####Carta natal rápida:
- Escorpio (susceptibles): se comunica por emociones / sentimientos. Intuitivo, perceptivo, pura energía psíquica. si logran usar su energía constructivamente, gran activo social, gran líder en potencia.
* Agua: pasiones compulsivas, temores irracionales, misericordia, amor incondicional...
* Sol en Escorpio en casa 10 (tengo los dones de Escorpio para el trabajo, ¡tendría que trabajar de psicólogo...).
- Ascendente Capri: los inconvenientes lo estimulan. NO suelen ser románticos.
* Descendente en Cáncer (ascendente Cancer) anhelan encontrar una pareja fiable, sensible y hogareña. Posible necesidad constante de recibir orientación y consejo de alguien que se considera superior. El mayor temor de un Descendente en Cancer es mostrar su propia autoridad y fuerza.
- Luna en Leo: propensión a hipersensibilidad. Intento acomodarme a intereses de otros.
- Las personas con el Medio Cielo (casa 10) en Escorpio son poderosas, ambiciosas, atractivas y transformadoras. Prefieren la privacidad a fanfarronear sobre su éxito y sus logros. Están extremadamente enfocados a dejar su huella en el mundo y dejar un legado. A menudo trabajan en puestos o carreras que requieren un fuerte sentido y conocimiento de lo oscuro, lo oculto y lo misterioso. Debido a su misterio y privacidad, pueden obtener una reputación de ser difíciles de trabajar o reservados.
- Soy Fijo y cardinal (de empezar), agua y fuego, y un poco más femenino que masculino.
- No tengo planetas hasta el tercer cuadrante = comprender el mundo y ganar popularidad, autoridad en la sociedad (no poder). Expansión de nuestro mundo gracias a la interacción. Casa 8: explorar territorio ajeno en busca de sentido.
- Fortuna en Virgo: no debe quedar ocioso durante mucho tiempo, tener una ocupación puede brindarle gran satisfacción personal.
##Casas:
01YO SOY (máscara). 02YO TENGO. 03YO PIENSO. 04YO SIENTO. 05YO CRIO. 06YO DISCRIMINO.
07YO ME RELACIONO. 08YO ME TRANSFORMO. 09YO DESEO. 10YO ME PROYECTO. 11YO PARTICIPO. 12YO ME AÍSLO.
Casa 1 (AC)	5° 59'	Capricornio (ascendente Capri)
Casa 2	18° 0'	Acuario ¿Trabajos sociales?
Casa 3	0° 40'	Aries ¿Abrir caminos intelectualmente?
Casa 4	2° 44'	Tauro ¿Familia con Tauro?
Casa 5	26° 23'	Tauro ¿Enseñar a los Tauro?
Casa 6	16° 11'	Geminis ¿Filtrar lo intelectual?
Casa 7	5° 59'	Cancer ¿Acompañar a los Cancer?
Casa 8	18° 0'	Leo ¿Leo me va a proteger económicamente?
Casa 9	0° 40'	Libra ¿Exploro el territorio Libra?
Casa 10 (MC)	2° 44'	Escorpio ¿Trabajo de psicólogo?
Casa 11	26° 23'	Escorpio ¿Protectores y compañeros Escorpio?
Casa 12	16° 11'	Sagitario ¿Pruebas de explorar?
####012notas08.txt  ##Planetas. Mucho planeta en Escorpio (la naturaleza es apasionada y la actividad sexual se multiplica en todas las direcciones, ¿y eso produce ser corto de vista je je?) y Leo (individuo atado a demasiadas fidelidades, ¿ya mejoré eso no?), alguno en Libra.:
- Sol en Escorpio 10 56. Casa 10. ¿Es mercurio en Escorpio y Mercurio en casa 10?
- Luna en Leo 3 17. Casa 7. 
- Mercurio en Escorpio 20 27. Casa 10.
* Mercurio casa 10: capta lo que el otro necesita. CONSEJERO.
- Venus en Libra 21 39. Casa 9.
* Venus 9: inspiración artística, con tendencia a lo espiritual, filosófico...
- Marte en Leo 3 7. Casa 7.
- Júpiter en Cancer 5 58 R. Casa 6 -> 7.
* Júpiter en Cancer: buena suerte en la vida.
- Saturno en Leo 29 14. Casa 8.
* Saturno en Leo: introvertido, poca confianza, me cuesta hacer lo que dicta el corazón. ¿Necesito reconocimiento de quienes me acogen? 
* Saturno 8: vida sana, larga, y vejez tranquila. Busca serenidad y estabilidad. Medito aislado.
- Urano en Escorpio 12 2. Casa 10.
* Urano en Escorpio: ama la vida intensamente (la vida sin cárcel).
- Neptuno en Sagi 14 36. Casa 11 -> 12.
- Plutón en Libra 15 7. Casa 9.
##Aspectos:
- Positivos o negativos, depende: la conjunción (0 grados). ¿Círculo con barra saliente?
- Positivos:
* Trígono (120, fuerte). Un triángulo.
* Sextil (60, fuerte). Un asterisco.
- Negativos:
* Oposición (180, fuerte). ¿Una barra entre 2 círculos?
* Cuadratura (90, fuerte). Un cuadrado.
* Quincuncio (150, semidébil). ¿Barra sobre pico?
* Semi-sextil (30, débil). ¿Valle sobre una barra.
* Sesquicuadratura (135, débil). Me recuerda a una Q.
- Sol 120 Júpiter, 0 Urano (A, no S).
* SOL CONJUNCIÓN URANO. Individualidad Creativa. Liberación de espacios para lo nuevo (lo viejo limitante, fuera). Si sienten tensión interna es posible que algo los esté limitando. La conciencia de sí mismos llega a través de flashes repentinos. Necesitan poder expresarse libremente y que a nadie se le ocurra decirles cómo deben comportarse. Ejemplos del deseo de cambio y progreso de la época. Comprenden instintivamente que cada ser humano es único. Si se encuentran en ambientes conservadores, rígidos, rutinarios... podrían crear caos.
- Luna 0 Marte, 90 MC = Escorpio (A).
- Plutón 0 Venus y 60 Neptuno.
* Venus Conjunción Plutón: valor en momentos cruciales, amor obsesivo y no realizado, mezcla amor espiritual y sexual.
- Neptuno sextil Plutón: voluntad de poder (lograrlo por vías raras, lejanas...). Reviso la religión, poniéndola al servicio de la gente en su día a día.
- Júpiter 120 urano y 180 AC = Capri.
* Júpiter oposición ascendente. La sociedad, o la familia, o el cónyuge, o el medio profesional... no serán los idóneos para la manifestación de su personalidad y deberá luchar toda su vida contra esa adversidad. Todo el pensamiento es grande, exagerado, descomunal, y a veces desproporcionalmente optimista. Es conformista si se trata de sí mismo, pero debe autoobligarse a mejorar su vida, ¿y su nivel de comodidad? cada vez que le sea posible. Eso sí, debe aprender a armar sus propias circunstancias, ¿no depender? Grandes negocios de otros pudieron haber comenzado con una idea suya. Debe aprender que la generosidad es un beneficio para usted, y también lo es aceptar la generosidad de otros. El nativo debe aprender a trabajar en equipo, para poder triunfar y cumplir con sus responsabilidades emocionales y económicas, que no le gusta que le recuerden.
- Marte 90 MC = Escorpio (A).
####Zodiaco chino:
- Rata: les gusta rodearse de familiares y amigos, a quienes ayudan en sus quehaceres y problemas diarios.
- Buey: paciente y tranquilo, irradia cariño y amor. Quieren orden y limpieza, y obtienen el éxito con esfuerzo. Aman el arte. No les gusta discutir, aunque sí que les obedezcan.
- Tigre, muy pasional y lleno de energía. Aventureros, independientes, ingeniosos, impulsivos y les gusta la diversión. Amigos para toda la vida, aunque les gusta ser el líder (y en pareja, el más fuerte y seductor).
- Conejo: prudentes, afables, discretos, previsores, atentos y benevolentes. Indulgentes (eso es negativo), aman la paz. Les gusta la vida tranquila, la ternura y la armonía.
- Dragón: imaginativo, emprendedor, afortunado y poderoso. Lleno de fuerza y vitalidad. No cree a nadie ni en nadie. Son muy sentimentales y se enamoran locamente, pero no les enfurezcas.
- Serpiente (yo): astutos, saben lo que quieren y cómo conseguirlo. Intensos y prudentes a la vez. Celosos y posesivos con su familia, pero leales. Les gusta mimar a sus amigos y esperan de ellos lo mismo. Son buenos para parecer tranquilos en situaciones difíciles. S se sienten ignorados, pueden enfadarse por horas.
- Caballo: optimistas, alegres, aventureros, elocuentes, impacientes, emprendedores. Su gran pasión es el dinero y los viajes (culturas nuevas...). Atractivo físico. Enamoradizos.
- Cabra: creativa, positiva, elegante, femenina, afable, compasiva, llorona, soñadora, orgullosa y triste. No persiguen la riqueza material. Aman la familia, los niños, el hogar y la naturaleza. Son muy trabajadoras, aunque no les gusta la presión.
- Mono: ingenioso, simpático, mente rápida y despierta, persuasivo, resolver cualquier problema. Relaciones: suelen ser conflictivas, no soporta que no lo valoren. Excesos en fiestas...
- Gallo: atractivo y seductor, talento (y meticulosos, eficientes y ordenados) y es apreciado. Conversadores, observadores, egoístas, usureros, pragmáticos y familiares. Amor: románticos, obstinados y luchan por el control de su pareja. Relaciones públicas o artistas.
- Perro: dedicado al trabajo, honesto, confiable, sentido justicia y lealtad. Personalidad excitante, buen humor, capacidad para escuchar los problemas de los demás. Amor: fieles y leales, celoso si la pareja no está en casa. Nervios.
- Cerdo: honesto, confiado, cariñoso, servicial, valiente, decidido, sin grandes pretensiones. Agradables, y gusto y modales "impecables". Muy trabajadores. Engordan: falta de atracción por el deporte y apatía.
##Flecos de Transgenealogía:
- Si quiero disfrutar, significa prohibición de placer, deseo... Si queremos amar, el clan nos limitará las emociones.
- El afecto es la felicidad por la prosperidad del prójimo.
- Una familia fue al cementerio a honrar a un muerto, y sus descendientes no corrieron su misma mala suerte.
- Tras el shock de descubrir la verdad sobre el ancestro, ¿7 días "acostado" con el ancestro involucrado, y así evitas el enfado con él?
- Los vicios pueden ser ancestrales. ¡Hasta se puede heredar la culpa por ellos!
####013notas09.txt  ####Arbolismo. Un árbol genealógico te permite detectar mejor las "casualidades", y "es mágico" (encuentras fricciones entre ancestros, informa "al Universo" de que quieres solucionar problemas transgeneracionales, y te ayuda y protege...):
- Busca fotos de padres, tíos y abuelos como mínimo (o cartulinas con nombre y parentesco). Poner en piso o en pared (en piso es más fácil, en pared necesitas quizás un tablón de corcho y chinchetas...):
* ¿Yo estaría abajo?
* ¿Qué sientes al emparejar ciertos ancestros? Rearma el árbol hasta que no dé "fricciones", y apunta lo que te venga a la cabeza.
* Pregúntate sobre las cosas que faltan (además, la falta puede dar pistas). Deja que el subconsciente rellene los huecos.
* Y cuando logres expresar tu Norte (objetivo de mejora interior para sanar al clan), éste coronará el árbol.
- Datos. ¿Ir al registro civil y al parroquial (yo me sé mi identificador de registro civil)?:
* Nombre, apellidos, fecha de nacimiento, casamiento y muerte (con causa exacta).
* Profesión.
* Relación de nuestros padres con sus padres.
* Hijos muertos. Abortos (voluntarios o no) y enfermedades.
* Efemérides (ruinas, éxitos, divorcios, secretos, anécdotas, accidentes, cambios de país, cárcel...).
##Un buen arbolista terapeuta será comprensivo:
- Primero pregunta por lo que no has conseguido en la vida todavía (pareja, hijos, casa propia...).
* ¿Qué quieres hacer? Séneca: no hay viento favorable para quien no sabe dónde va. Si no fuiste tenido en cuenta de niño, quizás no tengas finalidad.
* ¿Tu mundo ideal? ¿Qué 3 deseos pedirías a un hada?
- La voz del terapeuta debe ser emocional como mínimo. Otras:
* Libidinal (para conectar con el placer, ¿hablar paseando por una sala desde el sexo, con avidez de algo?).
* Intelectual. La peor, más sosa / baja, junto con la material. Inmorales casi.
- Más:
* El arbolista no cobra, ¿si él mismo no sube de conciencia tras la consulta? No juzga, limpia de "familia" y de CUltuRA.
* Analiza si el paciente se resiste (o si sufre y eso le empuja a colaborar).
- Preguntas para TI MISMO:
* Origen ancestral de mi nombre. ¿Fui deseado? ¿Esperaban a alguien de mi sexo?
* Parto. ¿Fue sencillo? ¿Tenías prisa por salir o fuiste diezmesino (retenido contra mi voluntad)? ¿Cesárea? ¿Mamá murió? ¿Me dieron de mamar el tiempo justo?
* Nacimiento mío y de otros: sumar 3, 6 y 9 meses. ¿A qué se acerca)?
* Convivencia con hermanos y actual. ¿Cooperación y fluidez o lucha territorial? ¿Tienen hijos? ¿En qué trabajan?
* Tu infancia: acontecimientos y salud. ¿Se separaron los padres? ¿Cambiaron de país, vivieron una guerra o un accidente de los que marcan? Personas de las que recibí cuidados, afecto y educación. Mascotas.
* Lugar del hijo, ¿Funcionaste como único? Parejas de hermanos, ¿Uno listo y otro torpe? ¿Uno simpático y el otro serio?
##Ejemplo. Árbol de Jung:
- Su abuelo paterno se casó con Sophia, que se llama como la madre del mismo. ¿Nudo incestuoso que heredaría Jung?
- Augusta es nombre medio masculino (esperaban un hombre).
- Mujeres consideradas "conejo":
* Los niños mayores no tenían infancia (cuidaban de los otros).
* Los más jóvenes eran considerados inmaduros por parte de los padres. ¡Marcados!
- Jung es tratado como hijo único (su hermano ya tenía 9 años).
* Tras una generación abundante, viene otra no abundante (es lo normal).
- Su conflicto ciencia - espiritualidad, viene de médicos (rama del padre) y sacerdotes (rama de la madre).
##Mi árbol:
- Padres:
* Amor de los Dolores (vaya nombrecito) Armada Álvarez, 21-04-1940. Ama de casa. Muerte, 19-11-1989.
* Rafael Mateos Castaño, 21-08-1937 (cuando nací, el ya tenía cierta edad). Trabajador de supermercado.
- Hermanos:
* Eduardo (mellizo).
* Rafael, 11-10-1971. Paga por toc y limpiezas.
- Tíos:
* Por parte de padre, destaco a Deme. Muy buena en clase, pero sus padres le cortaron un poco las alas (hacer un Bachillerato...). Ama de casa.
* Por parte de madre, destaco a Maruja. Algo depresiva y un poco en contra del "inmovilismo" de mi padre con sus hijos. La verdad es que los Armada, eran de mucho criticar, mucho acomplejar, y poco ayudar.
- Abuelos paternos:
* Lorenza (de la que ya hablé), nació en, ¿1909?
* Virgilio, que murió en, ¿1981?
####¿Qué datos pongo sobre mí?
- Quiero ser una persona capaz de ganarme el sustento, pero en una sociedad posterior a ésta (con la gente mejor).
- Me mueven los proyectos de concienciación sobre la roña / debilidad interior de la gente.
- En un mundo ideal no hay jerarquías artificiales casi (naturales sigue habiendo, por supuesto, padre - hijo...), se consume poco, hay mucho tiempo para estar quieto.
- Más datos:
* Nombre de mi abuelo materno.
* Mi mellizo y yo, vinimos tras mi hermano Rafael, tratado por mi madre como una niña un poco (mi hermana mayor fue raptada por monjas al nacer). Fui sietemesino, y salí el primero, ¿para tener mi difícil carta astral, sin importar mi mellizo? Me dieron de mamar muy poquito, quizás no llegó al año.
* Hermanos. NO tienen hijos ni trabajan. La relación con mi mellizo era algo territorial.
* Infancia: cada poco estaba en el médico. A los 3 años se murió mi "amigo" Virgilio (abuelo paterno). Mi madre no recibía suficiente cariño de mi padre, y se preocupaba mucho por nuestro éxito (lógicamente, murió de Cáncer; cuando yo tenía 12 años recién cumplidos). Mi padre tuvo una infancia bastante dura y austera. Mi abuela no era muy amorosa. Mi tía Deme, lo era más.
* ¿Ingeniero Informático? ¿Actor pedagógico (para que desreprimas)? ¿Limpiador, decorador, ordenador compulsivo?
- Efemérides (ruinas, éxitos, secretos, anécdotas, accidentes):
* Ruinas. 2003: Renée Ribacoba me da Topamax, no puedo casi levantarme de la cama, y Fanjul me toma por drogata cuando empezaba a subir la dosis. 2007 / 2008, Biblioteca de Proyectos, tortura oculta (con ironía) de JPM. EDP: el dejarlo (yo sé muy bien ocultar las lágrimas); en Aboño tenía todo el cariño tierno, y tardé muchos años en recuperarme. En 2012 (el año siguiente) pedía muchos trabajos, y nada, dificilísimo con la superdepre que tenía (suma a eso los rechazos). Me faltaba, por otra parte, mejorar como persona.
* Éxitos: he hecho programillas bastante interesantes (Paint para Windowes, que te limita a los colores del Spectrum...). Hay 2 cosas en los últimos años que me gusta recordar como éxitos: el teatro de idiomas, y la Cutreenciclopedia (dar luz psicológica...).
* Secretos: a los 16 años veía a los Tauro (los amores de Escorpio) con barba como figuras paternas, ¿o maternas? Da igual: homosexualidad leve (¿por morir Virgilio siendo yo niño?) y superficialidad. En la adolescencia "había" que hacer lo que hacía el resto, y terminé odiando las discotecas (y un poco a las mujeres; no sé, las veía muy difíciles).
* Anécdotas. En 2012, los de Delegación (colegas míos, aunque Pepe me dijese siempre "¿tú entiendes no?"; que si soy homosexual) pusieron mis vídeos tontos, y pensaban que no iba a aparecer por el Salón de Actos (lo tenia to aprobao), pero aparecí con Solares: cuchichearon, y decidieron darme la banda de Rey de la Politécnica.
* Accidentes: lo del Tiatordos, que tuvo que venir el 112 con cazadoras térmicas a rescatarnos! Por lo general yo no iba rápido en bici bajando, así que los que tenían accidentes eran los que venían detrás de mi, ¡aparta, que te trago (me decían)!
####014notas10a15Hamer más.txt  Hamer (más, no sólo ejemplos):
##Principio básico: la psique influye en lo emocional, y luego viene lo material (el órgano). La enfermedad (traumas por shock en tu vida, ¿secretos y traumas ancestrales influyendo en el ADN?...) está en la psique (si te tragas una tuerca y se te inflama todo, eso se llama desequilibrio).
- Es un error garrafal asociar el mal físico con lo material, salvo en unos pocos casos:
* Quemadura solar.
* Callo por zapato (aprieta).
* Digestión mala por comer en exceso o combinar mal.
* Talón de Aquiles rojo (como prevención por estar sin entrenar) y similar.
* Algunos más, supongo, ¿como cortes?...
- Por cada enfermedad, uno o varios focos de Hamer en el cerebro (creo que estoy repitiendo, pero merece la pena).
* La enfermedad tiene 2 fases: la activa (cuando no sabes lo que te pasa, y la vida intenta ponerte pruebas para que lo sepas; no, no son casualidades). La de curación, donde suelen estar los síntomas (y por eso la Medicina Universitaria es tan torpe; las farmacéuticas compraron la Universidad, y se acabó el curar), las manos están calientes...
* Aceptar o reprimir, impiden que muramos de agotamiento por fase activa (tu estado general es menos activo / masculino, y más de reparación / femenino). ¿Y vuelves a fase activa cuando a tu alma le parezca?
* En la fase de curación, hay una "de curación aguda", en la que podría ser preciso usar los métodos de la medicina oficial, puesto que los síntomas se disparan. Tras esta fase, los síntomas son incluso menores que en la primera parte de la fase de curación, y echas sangre, mocos...
* La escena que produce el trauma tiene unos detalles, incluso una comida (que luego generarán alergias, que te hablan de esa escena traumática; imagínate que eres alérgico a los cacahuetes; un cacahuete podría causarte inflamaciones, pero también podría guardar una información muy importante). No te curarás del todo hasta que no recompongas la escena, con sus detalles importantes, ¡y se te podría mandar a la fase activa otra vez! ¿Vuelves porque te faltan pistas por encontrar? Bueno, ahora las pruebas serán más fáciles.
####Seguimos:
- Los ambientes tóxicos (electromagnetismo...) pueden generar lo nunca visto; problemas psíquicos desde lo "material".
- Nuestro cuerpo está superpreparado para hacer frente a cualquier cuerpo extraño. Ya sabes que los síntomas como inflamaciones... suelen ser una defensa del cuerpo que funciona bien. Lo realmente peligroso es tener miedo (el miedo acorta conductos, las células ya no reciben alimento... El miedo es un artista en enfermedades respiratorias).
* Bacterias... se encargan del trabajo de reparación.
* Virus (proteína + ácido nucleico), ¿regeneran el ectodermo / la mucosa?.
- Tumor (fase activa), viene de 2 posibles partes del cerebro:
* Tronco cerebral / endodermo (no te trago / acepto... Conflictos de presa, generalizando, como no poder deshacerse de algo, o hacerse con algo).
* Cerebelo / mesodermo antiguo: conflictos sobre la integridad (física...): desfiguración (¿orgullo / imagen heridos se incluyen aquí?), preocupación (afecta a las mamas...), pelea...
- Pérdida celular (úlcera... en fase activa):
* Substancia blanca / mesodermo moderno (huesos: desvalorización... ¿hasta los tropezones están programados?): algo sale mal / has fallado en algo, te han despreciado / criticado... y te desvalorizas.
* Corteza cerebral / ectodermo (conflictos sociales "avanzados"): de separación, de territorio, impotencia, miedo a peligro... Fase activa: dolores de garganta y su mucosa, y similar.
##Algunos flecos:
- Meningitis: desvalorización moral o intelectual, ¿no te ves bondadoso o capaz?
* O por desfiguración (¿ser herido o sentirse atacado?)
* Aparece con el trigémino (ya lo veremos quizás y lo vimos por encima) en fase activa, y en fases de curación.
- Los pasotas son mentes débiles, necesitan la protección de la represión.
- La alergia (pistas) puede manifestarse como enfados repetidos (en el trabajo...).
- ¿Sólo en las enfermedades no psicológicas (que son muy pocas) se reducen significativamente los centrómeros celulares?
* ¿Podrían alargarse si curas de verdad (la psique)?
- Dolor: es para que no te muevas. ¡Así que no te muevas, cura!
- ¿A + fase activa, más miedo y más vello?
- Agotamiento: es protección, como un freno de emergencia de la gente sana (la muy activa... puede morir joven).
- Ante conflictos prolongados, se pueden alterar genes que hagan que "te levantes del sillón".
- Aborígenes curan fracturas en minutos, ¿herramientas imaginadas de realismo infantil? ¿Y una cuadrilla de espíritus?
####FINALIZANDO LO BÁSICO (ÚLTIMO TERCIO)
##Los médicos.
- Se protegen complicando términos (Latín = LOT-in... Cosas de paios loteros, ¡sí, relacionados con la Diosa Kali!). Autocurarnos sabiendo lo que nos pasa a nivel psicológico, es parte de nuestra misión de vida, es nuestra responsabilidad.
* Que hagan tests de cáncer a la sangre arterial: da negativo. Según la idea oficial de cáncer, lo sería un embrión, los pechos sanos de una mujer en determinadas circunstancias, o una herida curando. ¡DARÍAN POSITIVO EN EL TEST!
* + Mitos. La hipertensión casi nunca supone peligro vascular. ¿Usar diuréticos sólo como último recurso? Antibióticos (dañan genes): no terminar la caja. Radioterapia: para tumor inaccesible, o como último recurso. ¿Y antes tomar MMS y energizarse con energía escalar? Píldora (nunca, como la morfina): cambia lados cerebrales (esto es traumático), es una ruleta de conflictos y curaciones.
##Proceso de fase activa a fase de curación:
* Tras algunas experiencias, la información negativa sale a la luz (el trauma). ¿Pero también habrás tenido experiencias hasta darte cuenta de que reaccionas mal no? Quizás tengas que desreprimir varias veces por trauma / enfermedad, y decir varias veces, ¡basta ya (seguido de saber cual es el problema psicológico asociado a la reacción, y que se repite en varios aspectos de tu vida)!
* Pensamientos intrusivos (no necesariamente TOC) te acercan un poco más a lo que te pasa. ¿Mi padre me pintaba la habitación a traición para que me pusiese a decorar compulsivamente (para verme por fin bello; ¿mi abuelo Luis no se sentía bello?)?
* Curación: retener líquido, con síntomas "severos"; luego viene la fase de "urgencias", con escalofríos, epilepsias y fallos de corazón (fase de curación aguda, que no suele pasar de las 50 horas); la tercera de curación trata de expulsar líquido + cicatrizar (síntomas más suaves). A veces, con la epilepsia, se rememora el conflicto. Cuando venía de la Universidad, tenía epilepsias (sufría: mucha tarlla mental, dormir poco...).
##PROCEDIMIENTO BORRAR-NUEVO (para borrar un trauma que ya se ha solucionado; suena a la Psicología Energética Cuántica, que se mete en las células, los cuerpos sutiles...). ¿NO se borra la experiencia no (habría que repetir las pruebas de vida)?:
- 9 pasos:
1. Pedir asistencia, ¿a tu "ser superior" (tú en el futuro, más evolucionao)?
2. Nombra conflicto. Di al terapeuta si estás preparao.
3. Recostar en atmósfera agradable. Cerrar ojos. Reactivar conflicto (debe durar poco, para no volver a fase activa). Homeopatía, ¿moderna no? Pulverizar Uranium metallicum D60 (diluido en agua o alcohol) sobre órgano, ¿y región cerebral? Por fuera claro. ELECTRODO (centrífugo, para olvidar) SOBRE ELLOS 5 minutos (intensidad media). Al final, se ve / imagina el conflicto, como un nubarrón sobre ti.
4. 1 minuto. Gracias por aprender de la situación (puedes decirlo para ti mismo).
5. 3 minutos. Imaginar nubarrón alejado por viento, se deshace en cielo azul. Sientes libertad y ligereza.
6. 15 minutos (sentir de forma gozosa e intensa, en cuerpo y alma). "Confío en mí" (la frase que explica cómo has mejorado interiormente... Concretar más que yo) + música que llegue al alma del paciente + ¿estímulos luminosos que salen de gafas, sobre los ojos? ¿Siguen cerrados no?
* Adamas D6 (pulverizar sobre órgano y región cerebral), ¿para recordar?
* A los lados de la cabeza, aros magnéticos (centrípetos) de ferrita, con polo sur hacia dentro (que se dé cierta repulsión). ¿Para recordar?
7. 3 minutos. Imaginar situación adecuada para usar lo nuevo (todos me insultan, pero "confío en mí").
8. Dar gracias a quien te ayudó (del "mundo" espiritual; pongamos que no hay varios mundos / planos, hay uno, y ves o no ves lo inmaterial; ES ESENCIAL QUE CONCIBAMOS UN SOLO PLANO).
9. 3 semanas: pensar / sentir lo nuevo cada mañana tarde ("confío en mí", o la frase que toque).
####Repaso:
##Cuestiones consulta:
- ¿Manos frias o calientes? ¿Frio en calle o shock por la propia consulta? Diestro o zurdo. Edad: menopausia (45-55), a lado masculino (cambian las enfermedades). Hombres 70-75 a lado femenino, izquierdo.
* Hombre "femenino": zurdos sin constelacion o problema testículos.
* Mujer "masculina": zurda + territorial (ovario)...
- ¿Cual es la fase? Activo (gastritis, angina pecho, diabetes...). Curacion: hernia discal, neumonia... Tiene que suceder algo bueno (en tu interior) para la fase de curacion: jubilacion, examen aprobado, reconocimiento del jefe, ya no...
- ¿Peor suceso en ese tiempo? ¿Que te estresaba / daba + miedo? ¿Que te gustaria cambiar en tu vida y de que depende tu felicidad?
- El autor de violencia que no piensa en lo que hizo, no comenzara SBS, pero el destino podria pasarle factura. Si hay mala conciencia: SBS hombro.
- Lo ideal es aceptar que hiciste aljo "malo", y la culpa desaparece.
##En fase activa, nivel animico sólo (el origen es siempre la psique). ¿Significa que la neurolojia es un cero a la izquierda?
- Solo en su parte superficial el teatro es entretener. Las tragedias griegas tenian 2 fases (conflicto, vuelves a sentirlo, y curacion). La novelas deben ser así, y blancas.
* El teatro moderno esta vacio de sentido. Falta la unión con la naturaleza y la espiritualidad, y responsabilidad para curar.
##Procedimiento BORRAR-NUEVO (del propio Bjoorn, repasamos un poquitín de na):
- 2. Nombrar conflicto + ¿tas preparao? Responder voz alta.
- 6. Sustituir vacio por algo positivo. Sentir, ¡y pensar! De forma intensa...:
* A izquierda y derecha de cabeza, aros magnéticos (centripetos, para grabar) de ferrita.
- 9: 3 semanas, pensar / sentir lo nuevo cada mañada y tarde para fundirse.
##Varios:
- ¿Pérdida de ser querido afecta al testículo con frecuencia?
- Los huesos (sobre todo los planos) forman sangre, y si estan malitos...
- Desvalorizacion porque hija no cumple su ambicion deportiva.
- Niña 4 años, eccemas todo cuerpo. Conflicto inicial, el parto (separación, cesárea). Consecuencia: ataques dermatitis en curación.
- ¿Conflicto de decepcion por querer él separarse? ¿Tarda mucho en aparecer, si ella echa mucho de menos al principio?
- Miedo teritorial (mucosa larínea) cuando la agenda esta completa. Se decide no fijar fechas.
- Unico conflicto con el que no adelgazas: refugiado. Colectores del riñón, por tener miedo a perder... Materialismo en general.
- Mal alimentado: desvalorizacion, debil para mantener el territorio...
- Con alimentacion mala, si tienes buen humor... el PH es genial. PH: si te pasas, parásitos (envejeces, ¿a menos que uses cebolla...?).
- Con presion en meninges se produce el dolor de cabeza. Medidas: cabeza fria (baños frios...), pasear al fresco, protejer cabeza de sol y calor, glucosa "orgánica", sobre todo por la noche. Simpaticotonicos (vitamina C...). Mojar pies descarga la cabeza. Poca sal, para no retener ajua (aljo que empeora todos los SBSs). MMS es oxidante (tomar poco tiempo).
* Mucho dolor o fiebre, simpaticotonizar también: analgésicos naturales, duchas frio calor (o frias), bolsas hielo, especias picantes.
##Refugiado + SBS de otro conflicto, se llama "sindrome": heces solidas, tendencia al estreñimiento para aprovechar / ahorrar agua, retencion agua.
####Txumari, nuestro boticario de la abuela, con la NUEVA MEDICINA GERMÁNICA. Hay personas que jamás prueban la grasa y tienen colesterol. Aquí hay algo emocional. Txumari curó a mucha gente fuera de su consulta con esta pregunta, ¿has tenido algún shock? Alguno se desmayó y dio las gracias:
- ¿Ahora te sienta mal lo que antes te sentaba bien? Puede ser falta de amor que se espera. Cuando comprendas por qué esa necesidad de amor... sanarás en gran parte:
* ¿Si tienes cubiertas tus necesidades de amor tienes mejor flora intestinal, y ésta trabaja mejor (pues hala, a hacerse introvertido je je)? Lo mejor es tener unas necesidades ínfimas, eso es ser buena gente.
- Diabetes: no suelen dejar entrar el amor a sus vidas (se cierran, como la célula).
- Tumor en el ano porque su familia no le puso silla en Nochebuena (el ano representa la identidad, lugar que ocupo en mi clan).
- Una sinusitis puede ser por necesidades excesivas de comunicación e ira reprimida (no diste opinión sobre un plato que no te gustaba...).
- El polen es la parte masculina de las plantas, ¿el novio? MIENTRAS LA PERSONA ESTÁ PREOCUPADA DE SU ALERGIA, EL DOLOR PSÍQUICO BAJA.
-  Un chaval tenía un problema con el hueso radio, y su radio de acción era pequeño (su padre no le dejaba ser lo que él quería).
- Cuando un niño (0-8 años) tiene muchos mocos, es porque "no huele a la madre" (está ocupada...).
- El tumor en un perro puede ser simpático (mismas enfermedades que sus dueños). El perro podría tener un tumor también si ya no le dejas dormir en la cama, si cambia de lugar...
- Un mioma es el deseo inconsciente de ser madre, pero no es el momento, o no encuentro con quién...
- Obesidad: por ser niño no deseado, quieres hacerte notar con los kilos (por ejemplo). Pon una nota en los dulces que diga: aquí no está la verdadera dulzura.
- Lupus heritomastoso sistémico: me he sentido agredido y no he podido defenderme. Caso 1 (Lupus estomacal): no puedes digerir que no puedas defenderte del jefe. Caso 2 (pulmón): te asfixia estar cerca de alguien, sientes el aire venenoso.
##Iridología: el ojo izquierdo habla del pasado y lo emocionalmente no superado. El derecho, del presente.
#### Biografía del Doctor Hamer. NO la pongo, pero es muy interesante. ¡Los médicos "que defienden sólo la Universidad", al salón de reciclado pero ya!
####LAS MEDIDAS TERAPÉUTICAS EN LA NUEVA MEDICINA GERMÁNICA REQUIEREN SENTIDO COMÚN:
- Nuestros ancestros solían seleccionar a los individuos más sabios (no los más memorísticos, sino los psicológicos, álmicos) para servir como hechiceros y hombres de medicina.
* Ahora el paciente asume la responsabilidad de resolver un conflicto psicológico. ¡El médico tiene que ser un poco psicólogo, decirle las fases! El paciente percibe (debería) como aceptable el estar cansado y falto de energía por varias semanas en la fase de curación.
* ¿La gente no muere del cáncer, sino del pánico (suyo o producido por un ignorante), que dispara otros problemas? NADIE DEBE DEFENDER LO SUYO SI ES MALO, AUNQUE LES DÉ DE COMER, AUNQUE SEA DURO ACEPTAR QUE LLEVAN TODA LA VIDA HACIENDO MAL. Se necesitan neurocirujanos y expertos en cuidados intensivos eso sí. Para terminar, NO todo paciente deshauciado por la medicina oficial (muchos en las últimas) puede ser curado por la NMG, sólo la gran mayoría.
- Las reparaciones:
* Un animal en la fase de curación se mantiene quieto, duerme mucho y espera calmadamente hasta que alcanza el estado de salud. Y no se expone al Sol con edema. ¡BUENA INFORMACIÓN! ¡Abajo las empresas actuales!
* Los pacientes en la fase de curación sufren más durante la noche, hasta las 3 o 4 de la mañana (el día se acerca).
* Recordad que el temblor de manos es un buen síntoma (Parkinson; conflicto pendiente; no lo hay por desgracia).
- Más cosas:
* Bajo ninguna circunstancia debemos estar tentados a dividir la Nueva Medicina Germánica en subespecialidades.
* Cuando el conflicto del paciente ha sido resuelto (fin de fase activa), es importante llevar a cabo un TAC tan pronto como sea posible debido a la inminente crisis epileptoide. El ataque cardiaco ocurre aproximadamente de 2 a 6 semanas después de la solución del conflicto.
* Alzheimer: conflicto de separación en cada hemisferio. ¿A que guarda relación con los geriátricos? ¿Qué es lo primero, el geriátrico, o el Alzheimer? Bueno, también está la carencia de vitamina B12, y más cosillas (un no aceptar, negarse a ver la realidad...).
- El TOC. Dos conflictos activos (¿que provocan pequeña curbatura del estomago, cólera, gran miedo y autismo?). 
* Pongo mi ejemplo personal: primero un problema de territorio (no me dejan decorar mi propio cuarto, o se meten a cambiarlo sin mi permiso pintando y agudizando el asma). El segundo puede ser asco (al ver la habitación; ¿ayuda que tenga mucho de Libra en la carta astral? ¿Y los que tengan mucho Virgo, en vez de decorar, se lavarán las manos?) o impotencia quizás.
* Las cuatro reglas: 1. Psicología. ¿Problemas de autoestima en mi abuelo Luis? ¿Cuanto más me quiera REALMENTE o más bello me vea, menos decoraré? El cuarto es mi agujerito / refugio, no un enfermizo palacio suntuoso, doy gracias, y comprendo a quien se metió en mis cosillas. 2. El problema es el núcleo caudado, que lo tengo muy chiquitín, cada vez más, y hace que no pueda pasar de las cosas. 3. Cuando me dé por decorar, hago algo productivo (resumir, por ejemplo). 4. Cuando ya está uno más o menos bien, decir "yo no soy el TOC, el TOC viene a verme de vez en cuando, el hemisferio izquierdo hace jugarretas a veces". Yo no soy lo que el cerebro piensa en el momento.
* Miles de hámsteres fueron expuestos constantemente a humo de cigarrillo. Ninguno manifestó carcinoma bronquial o cáncer de pulmón.
* ¿Qué pasa si siempre tenemos miedo (por la tele...)? Que la célula trabajará siempre en modo simpáticotónico (activo), no vagotónico, vamos, que no se regenera.
* ¿Un foco de Hamer es un vórtice, un regenerador cuántico? Parece que sí.
#### REGRESION CON AYUDA, por Brian Weiss: 
- Todo lo que esa hermosa luz que imaginas toque, cuando se vaya esparciendo por tu cuerpo, todos los tejidos y órganos, cada fibra, cada célula de tu cuerpo, se relajará completamente, liberándose de todos los dolores y de todas las molestias.
* Ya te sientes profundamente apacible y tranquilo. Ahora siente o imagina que la luz se esparce desde lo alto de tu cabeza hacia abajo, por la frente, por detrás de los ojos... ¡Menudo tostón hasta llegar a los pies! 
- Dentro de un momento voy a contar hacia atrás, de cinco a uno. Cuando llegue a uno te encontrarás en un estado muy profundo, tu mente se habrá liberado de los límites normales del espacio y el tiempo. Puedes recordarlo todo.
* Basta con que abras los ojos y regresarás inmediatamente a tu estado normal, con pleno control, sintiéndote relajado y descansado.
- Si quieres continuar, imagina o siente que desciendes lentamente por una hermosa escalinata. Al pie hay una entrada con una luz intensa al otro lado. Caminas hacia la entrada, sabiendo que tu mente ya no está limitada por el tiempo ni por el espacio. Puedes recordar absolutamente todo lo que te ha ocurrido.
* Cuando cruces, estarás en otro momento. Deja que tu mente elija el momento, de esta vida o de cualquier otra. Puedes regresar a un momento en el que surgió un síntoma, un sentimiento o una relación turbulenta.
* Emerges a la luz. Primero te miras los pies. Miras qué calzado usas: zapatos, sandalias, descalzo... Ahora subes la vista por el cuerpo. Mira la ropa, manos. Ves cómo eres, si es de día o de noche, si estás adentro o afuera. Trata de saber la fecha.
* Mira a tu alrededor, observa la geografía, la arquitectura, las plantas y los árboles, si hay otras personas allí (podéis preguntaros cosas).
* Busca las respuestas a tus preguntas, a tus síntomas. Si hace falta, puedes retroceder o avanzar en el tiempo. Si sientes alguna inquietud, basta con que flotes por encima de tu cuerpo, observando sin sentir ni participar activamente. O si prefieres, abre los ojos y pon fin al ejercicio.
- Si no has puesto fin todavía. Tu mayor perspectiva te permite comprender por qué ocurrieron los acontecimientos y qué significan en realidad. Mira si alguna persona de esa vida está contigo en tu vida actual. Si quieres, ve al final de esa vida y experimenta tu muerte.
* Flota por encima del cuerpo y repasa tu vida. ¿Qué lecciones tuviste que aprender?
- Fin del evento. Ya es hora de regresar. Dentro de un momento voy a contar de uno a cinco. Cuando llegue a cinco, abre los ojos y estarás plenamente despierto, alerta y descansado. Lo recordarás todo.
* Uno: Todos los músculos, todos los nervios del cuerpo, completamente relajados. Dos: Despiertas poco a poco, te sientes muy bien. Tres: Más y más despierto y alerta. Cuatro: Casi despierto, te sientes estupendamente. Cinco: Abres los ojos completamente despierto y alerta, sintiéndote muy bien.
#### AUTO REGRESION: 
- Lugar tranquilo y cómodo. Recuestese (no se acueste, que podría dormirse). Cierre los ojos y relajese (busca en tu cuerpo y mente la ausencia total de tension. Evita los pensamientos). 
* Respire profunda y lentamente. Concentrese absolutamente en el ritmo de su respiracion. 
* Relaje su cuerpo a la vez que respira. Con cada inspiracion guarde el aire dentro suyo antes de exhalar y cuente mentalmente hasta 5. Es importante que la inhalacion se realice de la forma mas lenta y profunda posible. Con cada repeticion piense que su cuerpo se va relajando. 
* Parece uan copia. Concentrese en el sonido de su respiracion y evite todo pensamiento. Su respiracion debe ser profunda y constante. 
- Imaginese a Ud flotando y deje que el agua lo lleve. Deje que los recuerdos lleguen a Ud.
####Y más:
- Tumor en ventriculos cerebrales:
* Lado derecho cerebro: no obtener algo. Lado izquierdo: no poder deshacerse de algo.
- Conflicto: por creer que no se puede pensar lo suficiente (adenocarcinoma en red vascular para suministrar mas liquido cerebral, quizás porque piensas que no puedes memorizar nada al estudiar o entender los problemas de matemáticas).
- Conflicto de presa: muy poca luz, esta muy oscuro:
* Se sufre por falta de luz del dia (mineros...). Uno se siente separado de Dios y abandonado por los ángeles. Entonces se produce mas melatonina para podernoslas arreglar con menos luz.
* Terapia: se debe dormir lo suficiente, y cuidar el ritmo de sueño. Tomar enerjia del sol (la que puedas). Mirar al sol al atardecer. Visualizar, ser creativo, meditar (quedarse embobao). Evitar flúor, cafeína, azucar y demas venenos. IDEA CENTRAL: SOY SIEMPRE CONSCIENTE DE MI ORIJEN DIVINO. SU LUZ ME ILUMINA.
##Insomnio:
- Causas:
* Fuerte actividad conflicto (estres). Estas despierto para resolver el conflicto.
* Fuerte curacion. Por el dia tas cansao, no te duermes hasta muy tarde, bien porque el cuerpo quiere que estes vigilante por la noche (por estar débil), bien para no caer en una supervagotonía (de supercuración) por la noche. El café puede ayudar en fase de curacion (aunque suene increíble), ¡pero por el día cede y echa siesta por el dia!
* Pausas nocturnas de respiracion por relajacion del paladar (impide paso aire, y es mas frecuente en obesos). Fuertes ronquidos se alternan con larjas pausas de respiracion.
* Hipertiroidismo o Hiperfuncion de corteza / medula suprarrenal.
* Miedo a la muerte.
- Terapia:
* Mantener pies calientes (baño, calcetines).
* Movimiento abundante. Pasar tarde tranquilamente (sin TV / ordi?). No cenar tarde.
* Acostarse siempre a la misma hora y no muy tarde.
* Rituales de desconexion: respiraciones profundas en la cama, pasar revista del dia, "despedirse" del dia y desconectar.
####Ojo:
- Blefaritis, conjuntivitis:
* Perder a aljuien de vista. Separacion visual. Un niño permanece con los abuelos durante las vacaciones de sus padres. Al rejresar estos, curacion (conjuntivitis).
* Otro ejemplo: distanciamiento de intereses con la pareja. Ella lo -a perdido de vista. Cuando deja de importarle el asunto, conjuntivitis (curacion).
* El ultimo: costumbre reunirse todos juntos dia Difuntos (te encanta). Desde -ace 8 años no ocurre la reunion. De repente vuelve, y -ay conjuntivitis (curacion).
- Ojos secos, causas:
* Efectos secundarios pildora, duireticos, para la presion arterial, antidepresivos, colirios vasoconstrictores...
* Falta de estrojenos con la edad. La falta de -ormonas des-idrata.
* Trabajar ordenador o ver tele: se parpadea con menos frecuencia, -ay menos "lajrima".
* Pocos estimulos de la naturaleza: luz, ajua, aire...
* La falta de movimiento reduce el metabolismo en jeneral.
- Sensibilidad a la luz, dilatacion excesiva pupila, cejuera duirna, pupila irrejular:
* Presa. Ojo derec-o, no consijo aljo por estar oscuro. Izquierdo: no me des-ajo de aljo / no puedo evitar aljo desajradable o pelijroso. Esta oscuro. En sentido fijurado: no se recibe suficiente atencion. Quizas no poder encontrar lo espiritual (que se encuentra en tu oscuridad, basicamente), lo luminoso, la claridad.
* Ejemplo: obrero competente y cualificado con muc-a experiencia compite por un puesto en la oficina de empleo con auxiliares no cualificados. "NO recae suficiente luz sobre su cualificacion".
- Estrabismo:
* Converjente: no querer ver mas a aljuien o contemplar uan situacion insoportable. No poder -uir de una situacion sin esperanza. Ejemplo: el ojo "pareja" se desvia al interior para acojer al padre, que tras el divorcio, esta lejos.
* Diverjente: se ec-a de menos a aljuien / aljo y se busca "-acia fuera". NO poder o no querer ver a aljuien / aljo. Ejemplo: el ojo desviado busca al padre en la distancia. ¿Antes del divorcio ya empiezan a distanciarse los ojos del niño (los padres discuten y se da cuenta...)?
* -ipertropia, ciclotropia: no poder, deber o querer mirar -acia arriba o -acia abajo. No poder, deber o querer mirar -acia dentro y abajo o -acia fuera y arriba, o bien jirar el ojo. En la practica, no querer ver a aljuien o aljo. Jeneralmente conflicto activo-pendiente.
####+ del cerebro:
##Ictus (ataque cerebrovascular):
- Conflicto motor: frio (paralisis, menos frecuente) o caliente (fulminante fase de curacion).
- Frio. Miedo de ser inmovilizado. NO poder, deber o querer moverse.
* Musculatura facial: quedar en ridiculo.
* Musculatura -ombros y espalda: no poder evitar aljo / a aljuien.
* Abductores flexores (brazos y piernas): no poder sujetar aljo, acercar o abrazar a aljuien. ¡Que cabrones los del coronavirus! Saben y actuan sibilinamente.
* Abductores extensores: no librarse, apartarse de aljuien / aljo; empujarlo o rec-azarlo, sacudirlo. A mi me da cuando aljuien -abla mas de lo normal (sin duda falta de empatia).
* Pierna en jeneral: no saber como sejuir. NO poder correr suficientemente rapido, escalar, subir, bailar, saltar, mantener el equilibrio... ¿Y si no -as consejuido todavia -acer malabares?
* Sentido biolojico: reflejo de -acerse el muerto. En el mundo animal, al terminar el pelijro, termina la paralisis.
* Suele considerarse erroneamente debilidad muscular, EM o ELA. Si el paciente tiene problemas del -abla, -ay un conflicto en curacion de panico, o de no poder -ablar. Lajunas mentales pueden llevar al ictus (separacion en crisis de curacion).
- Caliente.
* Ejemplos. Un paciente es retenido desde niño por su madre dominante. Es -ijo unico y se escapa. Durante toda su vida se siente responsable de su madre y culpable porque no la visita lo suficiente (conflicto motor al no poder "des-acerse" de la madre). Tras la muerte de la madre, le da un jrave ictus (al fin y al cabo, curacion). otro: no poder sejuir el camino que uno quiere, no abandonar la empresa.
* fase de curacion: lo mas frecuente es en brazo o pierna en un lado.
* Terapia: aceptar la situacion como es y tener fe en curacion o mejora, si no, + conflictos probablemente (motor / desvalorizacion).
##Mas:
- Encefalitis (cerebro y / o meninjes):
* Conflicto: se corresponde con la localizacion del tumor.
* Fase de curacion: cada foco -amer en curacion causa encefalitis (mayor si -ay varios conflictos en curacion). La encefalitis no tiene nada que ver con uan infeccion.
- Meninjitis, meninjoencefalitis:
* Desvalorizacion moral-intelectual.
* Fase de curacion: -uesos craneo producen liquido intersticial: separacion de meninjes "en direccion al cerebro". Fuertes dolores de cabeza.
* Otras posibles causas: SBS del trijemino o als meninjes (en curacion). Relacion con conflicto de desfijuracion (ser -erido o sentirse atacado).
- -idrocefalia:
* Debido a obstruccion, al acumulacion de liquido -ace aumentar el tamaño ventricular.
* Conflicto: refujiado activo o [refujiado + curacion de otro].
* Fase: curacion intensiva. ¿Esto no es la crisis de curacion?
* Terapia: como ultimo recurso, -acer como la medicina oficial: tubo plastico en cerebro para que pueda salir liquido cefalorraquideo.
- Neurofibroma (tumor del nervio), "lobanillo":
* Conflicto: contacto o dolor. Se percibe un contacto como doloroso, molesto o no deseado. Empujon, jolpe, caida, dolores -uesos... El orjanismo puede anular la sensibilidad periferica (dolor). Con la -inc.azon del recubrimiento de los nervios se atenua el dolor. En fase de curacion posible -ipersensibilidad inicial.
* Terapia: "Una capa protectora me proteje. Solo dejo que se acerquen personas o cosas que me -acen bien". Esto me suena a fatija cronica. Operar es arriesjado.
####Autismo (no he dicho asperger / cabeza fresca por usar básicamente el hemisferio izquierdo / tonto exactamente). Conflicto de pánico o de no poder hablar y conflicto de enojo territorial (diestro / a: conductos biliares con cálculos como primer conflicto). Sentido biológico: trabajador aplicado que no para hasta el final, para la manada:
- Parte derecha temporal atrás, parte izquierda delante. Eso, si es un hombre heterosexual. Un hombre homosexual actuaría como una mujer (creo), y una mujer lesbiana, como un hombre (pero una mujer madura actúa como un hombre, y...).
* Muchos olvidan, ¿por crisis de ausencia no epiléptica? ¿Y tienes que empezar de cero a explicarles? LA "MUJER" (EQUIVALENTE) TIENE UN CONFLICTO DE IDENTIDAD (y primero, el conflicto asociado a la laringe). Cuantas más pruebas les haces, más los traumatizas.
* Los autistas maniacos ("no puedo, estoy ocupado"; y así no contactan con la gente; yo no contacto, porque no saben mucho de moralidad), me suenan a enojados. Si a alguien le va la tecnología...
* Investigación. ¿Cómo vivió el feto lo que le pasó a la madre (un robo...)? ¿Dónde empieza el retraso madurativo (tu cabeza almacena información y quizás saques dieces, pero no aprendes muy bien de la experiencia)? Grandes peleas entre padres, padre ausente, violencia, gritos... Cuando nacen en el hospital y los separan momentáneamente de mamá... Y con la cesárea, otro trauma (ni nacen; psicológicamente, pueden tener marcado "que algo falta", ¿y eso se relaciona con el hígado, puede ser un problema territorial?).
####La homosexualidad, Hamer (Nueva Medicina Germánica):
- El conflicto de "miedo" es propiamente femenino y el de "territorio", masculino (yo perdí a mi abuelo Virgilio, y me femineicé). Ciertos pares de traumas, pueden femineizar al hombre (masculinizarlo si es zurdo), y tras parir un varón, la madre femeneizará en el útero a los siguientes varones SEGUIDOS:
* La castración no se trata sólo de la pérdida de pequeños órganos.
* Un trauma emocional con el sexo opuesto (que te rechacen las muy...), puede provocar que el individuo cambie el centro rector de su sexualidad para evitar "toparse" con la repetición de su trauma. Una humillación constante y una minusvaloración de su virilidad, hace que el hombre se feminice y, ulteriormente, desarrolle fobia por las mujeres.
* Con el cambio de hemisferios, se produce una disociación mental "esquizofrénica" (el hemisferio no apagado no se puede hacer cargo por completo de la situación).
* El empate hormonal (andrógino) es perfectamente natural en la especie humana y se vive cuando las mujeres alcanzan la menopausia y los hombres la andropausia física.
####Caso completo: Carcinoma de esófago (tercio inferior):
- CONTENIDO DEL CONFLICTO BIOLÓGICO. No sentirse capaz de tragar un bocado. Frecuentemente relacionado al hogar, vehículo, o algo similar. El bocado es algo que uno quiere "incorporar", pero de repente no es capaz. El cáncer de esófago significa que uno quiere tragar el bocado pero no puede. En contraste, en el cáncer de epitelio escamoso, uno es forzado a tragar algo, pero no es deseado, uno se siente como si fuera a escupirlo. Esta diferencia, en principio, aplica a la totalidad del área oral y nasofaríngea.
- FOCO DE HAMER (FH) EN EL CEREBRO. FH en bulbo (puente troncoencefálico), región lateral, derecha.
- FASE ACTIVA = SIMPATICOTONÍA = CRECIMIENTO TUMORAL.
* Tipo secretor: aumento celular para digerir y tragar el bocado.
* Tipo plano reabsortivo: para probar la consistencia de la comida (igual que la boca).
- FASE DE RESOLUCIÓN DE CONFLICTO = VAGOTONÍA. Destrucción del tumor mediante degradación caseosa.
* Los residuos a menudo son mal interpretados como "varices esofágicas". Previamente, estaba mal interpretado también como un indicador de cirrosis hepática con mal pronóstico.
* Junto con el "síndrome" (retención de agua), los tumores esofágicos pueden producir sangrados amenazantes, particularmente cuando se sangra al intestino. Típicamente, el paciente tiene sudoraciones nocturnas y se encuentra extremadamente cansado. Los pacientes pueden hacer frente mucho mejor cuando conocen que las complicaciones son temporales, y que el sangrado puede ser regulado con, ¿transfusiones eventuales (agua de mar siempre, agua de mar)? hasta que se complete el proceso de sanación.
####Terminando:
- HOMOSEXUALIDAD. Hombres (hemisferio derecho): pérdida territorial (de una persona). Arterias coronarias (zurdo, más masculino: venas). Mujeres: frustración sexual (¿o venas?). El mecanismo de supervivencia de los homosexuales protege los asociados cerebrales y órganos implicados.
* Cuanto más reprimas tu parte femenina, más teatro de macho harás, y más homosexual serás. ¡Casi todos los hombres que conozco son homosexuales de alguna u otra forma!
* ¿Las almas viejas tienden a la bisexualidad por ser avanzadas y haber encarnado tantas vidas como hombre y mujer?
* Se produce antes de la madurez biológica (¿14-16 años?), y originalmente antes de los 7 años.
- Epilepsia ACTIVA: no poder moverse o seguir a los demás incluso al hablar.
* Si de repente pasas de ellos o ya no estás con ellos, ¿llega el desmayo?
- Enojo territorial (conflicto de presa podría ser): el puesto (bocado podría ser) era para ti, y en el último momento se lo lleva otro, ¿o se lo lleva alguien que crees que se lo merece menos?
* Miedo territorial (conflicto de ectodermo podría ser), ¿alguien te puede quitar algo que es tuyo, pero no lo ha hecho todavía?
